64
20 30
1
Resourses//test.png
0 0 0 0 0 0 0 0 0 64 2 0 192 0 1 1 0 0 0 0 0 0 0 0 0 0 0 0 0 0 0 0 192 0 1 1 0 0 0 0 0 0 0 0 0 0 0 0 0 0 0 0 192 0 1 1 0 0 0 0 0 0 0 0 0 0 0 0 0 0 0 0 192 0 1 1 0 0 0 0
0 0 0 0 0 0 0 0 0 0 0 0 192 0 1 1 0 0 0 0 0 0 0 0 0 0 0 0 0 0 0 0 192 0 1 1 0 0 0 0 0 0 0 0 0 0 0 0 0 0 0 0 192 0 1 1 0 0 0 0 0 0 0 0 0 0 0 0 0 0 0 0 192 0 1 1 0 0 0 0
0 0 0 0 0 0 0 0 0 0 0 0 192 0 1 1 0 0 0 0 0 0 0 0 0 0 0 0 0 0 0 0 192 0 1 1 0 0 0 0 0 0 0 0 0 0 0 0 0 0 0 0 192 0 1 1 0 0 0 0 0 0 0 0 0 0 0 0 0 0 0 0 192 0 1 1 0 0 0 0
0 0 0 0 192 0 1 1 0 0 0 0 0 0 0 0 0 0 0 0 0 0 0 0 0 0 0 0 0 0 0 0 192 0 1 1 0 0 0 0 0 0 0 0 0 0 0 0 0 0 0 0 192 0 1 1 0 0 0 0 0 0 0 0 0 0 0 0 0 0 0 0 192 0 1 1 0 0 0 0
0 0 0 0 0 0 0 0 0 0 0 0 192 0 1 1 0 0 0 0 0 0 0 0 0 0 0 0 0 0 0 0 192 0 1 1 0 0 0 0 0 0 0 0 0 0 0 0 0 0 0 0 192 0 1 1 0 0 0 0 0 0 0 0 0 0 0 0 0 0 0 0 192 0 1 1 0 0 0 0
0 0 0 0 0 0 0 0 0 0 0 0 192 0 1 1 0 0 0 0 0 0 0 0 0 0 0 0 0 0 0 0 192 0 1 1 0 0 0 0 0 0 0 0 0 0 0 0 0 0 0 0 192 0 1 1 0 0 0 0 0 0 0 0 0 0 0 0 0 0 0 0 192 0 1 1 0 0 0 0
0 0 0 0 0 0 0 0 0 0 0 0 192 0 1 1 0 0 0 0 0 0 0 0 0 0 0 0 0 0 0 0 0 0 0 0 0 0 0 0 0 0 0 0 0 0 0 0 0 0 0 0 192 0 1 1 0 0 0 0 0 0 0 0 0 0 0 0 0 0 0 0 192 0 1 1 0 0 0 0
0 0 0 0 0 0 0 0 0 0 0 0 192 0 1 1 0 0 0 0 0 0 0 0 0 0 0 0 0 0 0 0 192 0 1 1 0 0 0 0 0 0 0 0 0 0 0 0 0 0 0 0 192 0 1 1 0 0 0 0 0 0 0 0 0 0 0 0 0 0 0 0 192 0 1 1 0 0 0 0
0 0 0 0 0 0 0 0 0 0 0 0 192 0 1 1 0 0 0 0 0 0 0 0 0 0 0 0 0 0 0 0 192 0 1 1 0 0 0 0 0 0 0 0 0 0 0 0 0 0 0 0 192 0 1 1 0 0 0 0 0 0 0 0 0 0 0 0 0 0 0 0 192 0 1 1 0 0 0 0
0 0 0 0 0 0 0 0 0 0 0 0 192 0 1 1 0 0 0 0 0 0 0 0 0 0 0 0 0 0 0 0 192 0 1 1 0 0 0 0 0 0 0 0 0 0 0 0 0 0 0 0 192 0 1 1 0 0 0 0 0 0 0 0 0 0 0 0 0 0 0 0 192 0 1 1 0 0 0 0
0 0 0 0 0 0 0 0 0 0 0 0 192 0 1 1 0 0 0 0 0 0 0 0 0 0 0 0 0 0 0 0 192 0 1 1 0 0 0 0 0 0 0 0 0 0 0 0 0 0 0 0 192 0 1 1 0 0 0 0 0 0 0 0 0 0 0 0 0 0 0 0 192 0 1 1 0 0 0 0
0 0 0 0 0 0 0 0 0 0 0 0 192 0 1 1 0 0 0 0 0 0 0 0 0 0 0 0 0 0 0 0 192 0 1 1 0 0 0 0 0 0 0 0 0 0 0 0 0 0 0 0 192 0 1 1 0 0 0 0 0 0 0 0 0 0 0 0 0 0 0 0 192 0 1 1 0 0 0 0
0 0 0 0 0 0 0 0 0 0 0 0 192 0 1 1 0 0 0 0 0 0 0 0 0 0 0 0 0 0 0 0 192 0 1 1 0 0 0 0 0 0 0 0 0 0 0 0 0 0 0 0 192 0 1 1 0 0 0 0 0 0 0 0 0 0 0 0 0 0 0 0 192 0 1 1 0 0 0 0
0 0 0 0 0 0 0 0 0 0 0 0 0 0 0 0 0 0 0 0 0 0 0 0 0 0 0 0 0 0 0 0 192 0 1 1 0 0 0 0 0 0 0 0 0 0 0 0 0 0 0 0 192 0 1 1 0 0 0 0 0 0 0 0 0 0 0 0 0 0 0 0 192 0 1 1 0 0 0 0
0 0 0 0 0 0 0 0 0 0 0 0 192 0 1 1 0 0 0 0 0 0 0 0 0 0 0 0 0 0 0 0 192 0 1 1 0 0 0 0 0 0 0 0 0 0 0 0 0 0 0 0 192 0 1 1 0 0 0 0 0 0 0 0 0 0 0 0 0 0 0 0 192 0 1 1 0 0 0 0
0 0 0 0 0 0 0 0 0 0 0 0 192 0 1 1 0 0 0 0 0 0 0 0 0 0 0 0 0 0 0 0 192 0 1 1 0 0 0 0 0 0 0 0 0 0 0 0 0 0 0 0 192 0 1 1 0 0 0 0 0 0 0 0 0 0 0 0 0 0 0 0 192 0 1 1 0 0 0 0
0 0 0 0 0 0 0 0 0 0 0 0 192 0 1 1 0 0 0 0 0 0 0 0 0 0 0 0 0 0 0 0 0 0 0 0 0 0 0 0 0 0 0 0 0 0 0 0 0 0 0 0 192 0 1 1 0 0 0 0 0 0 0 0 0 0 0 0 0 0 0 0 192 0 1 1 0 0 0 0
0 0 0 0 0 0 0 0 0 0 0 0 192 0 1 1 0 0 0 0 0 0 0 0 0 0 0 0 0 0 0 0 192 0 1 1 0 0 0 0 0 0 0 0 0 0 0 0 0 0 0 0 192 0 1 1 0 0 0 0 0 0 0 0 0 0 0 0 0 0 0 0 192 0 1 1 0 0 0 0
0 0 0 0 0 0 0 0 0 0 0 0 192 0 1 1 0 0 0 0 0 0 0 0 0 0 0 0 0 0 0 0 192 0 1 1 0 0 0 0 0 0 0 0 0 0 0 0 0 0 0 0 192 0 1 1 0 0 0 0 0 0 0 0 0 0 0 0 0 0 0 0 192 0 1 1 0 0 0 0
0 0 0 0 0 0 0 0 0 0 0 0 192 0 1 1 0 0 0 0 0 0 0 0 0 0 0 0 0 0 0 0 192 0 1 1 0 0 0 0 0 0 0 0 0 0 0 0 0 0 0 0 192 0 1 1 0 0 0 0 0 0 0 0 0 0 0 0 0 0 0 0 192 0 1 1 0 0 0 0
0 0 0 0 0 0 0 0 0 0 0 0 192 0 1 1 0 0 0 0 0 0 0 0 0 0 0 0 0 0 0 0 192 0 1 1 0 0 0 0 0 0 0 0 0 0 0 0 0 0 0 0 192 0 1 1 0 0 0 0 0 0 0 0 0 0 0 0 0 0 0 0 192 0 1 1 0 0 0 0
0 0 0 0 0 0 0 0 0 0 0 0 192 0 1 1 0 0 0 0 0 0 0 0 0 0 0 0 0 0 0 0 192 0 1 1 0 0 0 0 0 0 0 0 0 0 0 0 0 0 0 0 192 0 1 1 0 0 0 0 0 0 0 0 0 0 0 0 0 0 0 0 192 0 1 1 0 0 0 0
0 0 0 0 0 0 0 0 0 0 0 0 192 0 1 1 0 0 0 0 0 0 0 0 0 0 0 0 0 0 0 0 192 0 1 1 0 0 0 0 0 0 0 0 0 0 0 0 0 0 0 0 192 0 1 1 0 0 0 0 0 0 0 0 0 0 0 0 0 0 0 0 192 0 1 1 0 0 0 0
0 0 0 0 0 0 0 0 0 0 0 0 0 0 0 0 0 0 0 0 0 0 0 0 0 0 0 0 0 0 0 0 192 0 1 1 0 0 0 0 0 0 0 0 0 0 0 0 0 0 0 0 192 0 1 1 0 0 0 0 0 0 0 0 0 0 0 0 0 0 0 0 192 0 1 1 0 0 0 0
0 0 0 0 0 0 0 0 0 0 0 0 192 0 1 1 0 0 0 0 0 0 0 0 0 0 0 0 0 0 0 0 192 0 1 1 0 0 0 0 0 0 0 0 0 0 0 0 0 0 0 0 192 0 1 1 0 0 0 0 0 0 0 0 0 0 0 0 0 0 0 0 192 0 1 1 0 0 0 0
0 0 0 0 0 0 0 0 0 0 0 0 192 0 1 1 0 0 0 0 0 0 0 0 0 0 0 0 0 0 0 0 192 0 1 1 0 0 0 0 0 0 0 0 0 0 0 0 0 0 0 0 192 0 1 1 0 0 0 0 0 0 0 0 0 0 0 0 0 0 0 0 192 0 1 1 0 0 0 0
0 0 0 0 0 0 0 0 0 0 0 0 192 0 1 1 0 0 0 0 0 0 0 0 0 0 0 0 0 0 0 0 0 0 0 0 0 0 0 0 0 0 0 0 0 0 0 0 0 0 0 0 192 0 1 1 0 0 0 0 0 0 0 0 0 0 0 0 0 0 0 0 192 0 1 1 0 0 0 0
0 0 0 0 0 0 0 0 0 0 0 0 192 0 1 1 0 0 0 0 0 0 0 0 0 0 0 0 0 0 0 0 192 0 1 1 0 0 0 0 0 0 0 0 0 0 0 0 0 0 0 0 192 0 1 1 0 0 0 0 0 0 0 0 0 0 0 0 0 0 0 0 192 0 1 1 0 0 0 0
0 0 0 0 0 0 0 0 0 0 0 0 192 0 1 1 0 0 0 0 0 0 0 0 0 0 0 0 0 0 0 0 192 0 1 1 0 0 0 0 0 0 0 0 0 0 0 0 0 0 0 0 192 0 1 1 0 0 0 0 0 0 0 0 0 0 0 0 0 0 0 0 192 0 1 1 0 0 0 0
0 0 0 0 0 0 0 0 0 0 0 0 192 0 1 1 0 0 0 0 0 0 0 0 0 0 0 0 0 0 0 0 192 0 1 1 0 0 0 0 0 0 0 0 0 0 0 0 0 0 0 0 192 0 1 1 0 0 0 0 0 0 0 0 0 0 0 0 0 0 0 0 192 0 1 1 0 0 0 0