64
30 20
1
Resourses//firstlevel.png
384 0 0 0 384 0 0 0 384 0 0 0 0 0 1 1 384 0 0 0 384 0 0 0 384 0 0 0 384 0 0 0 384 0 0 0 384 0 0 0 384 0 0 0 384 0 0 0 384 0 0 0 384 0 0 0 384 0 0 0 384 0 0 0 384 0 0 0 384 0 0 0 384 0 0 0 384 0 0 0
384 0 0 0 384 0 0 0 384 0 0 0 0 0 1 1 384 0 0 0 384 0 0 0 384 0 0 0 384 0 0 0 0 0 1 1 0 0 1 1 0 0 1 1 0 0 1 1 384 0 0 0 0 0 1 1 0 0 1 1 0 0 1 1 0 0 1 1 0 0 1 1 0 0 1 1 384 0 0 0
384 0 0 0 0 0 1 1 384 0 0 0 0 0 1 1 0 0 1 1 0 0 1 1 0 0 1 1 0 0 1 1 0 0 1 1 384 0 0 0 384 0 0 0 384 0 0 0 384 0 0 0 384 0 0 0 384 0 0 0 384 0 0 0 0 0 1 1 384 0 0 0 0 0 1 1 384 0 0 0
384 0 0 0 0 0 1 1 384 0 0 0 384 0 0 0 384 0 0 0 384 0 0 0 384 0 0 0 384 0 0 0 384 0 0 0 384 0 0 0 384 0 0 0 384 0 0 0 384 0 0 0 384 0 0 0 384 0 0 0 384 0 0 0 384 0 0 0 384 0 0 0 0 0 1 1 384 0 0 0
384 0 0 0 0 0 1 1 384 0 0 0 0 0 1 1 0 0 1 1 0 0 1 1 0 0 1 1 0 0 1 1 0 0 1 1 0 0 1 1 0 0 1 1 0 0 1 1 0 0 1 1 0 0 1 1 0 0 1 1 0 0 1 1 0 0 1 1 0 0 1 1 0 0 1 1 384 0 0 0
384 0 0 0 0 0 1 1 384 0 0 0 384 0 0 0 384 0 0 0 384 0 0 0 384 0 0 0 384 0 0 0 384 0 0 0 384 0 0 0 384 0 0 0 384 0 0 0 384 0 0 0 384 0 0 0 384 0 0 0 384 0 0 0 384 0 0 0 384 0 0 0 0 0 1 1 0 0 1 1
384 0 0 0 0 0 1 1 384 0 0 0 0 0 1 1 0 0 1 1 0 0 1 1 0 0 1 1 0 0 1 1 0 0 1 1 0 0 1 1 0 0 1 1 0 0 1 1 0 0 1 1 0 0 1 1 384 0 0 0 0 0 1 1 0 0 1 1 0 0 1 1 0 0 1 1 384 0 0 0
384 0 0 0 0 0 1 1 384 0 0 0 0 0 1 1 384 0 0 0 384 0 0 0 384 0 0 0 384 0 0 0 384 0 0 0 384 0 0 0 384 0 0 0 384 0 0 0 384 0 0 0 384 0 0 0 384 0 0 0 0 0 1 1 384 0 0 0 384 0 0 0 0 0 1 1 384 0 0 0
384 0 0 0 0 0 1 1 384 0 0 0 0 0 1 1 384 0 0 0 384 0 0 0 384 0 0 0 384 0 0 0 384 0 0 0 0 0 1 1 384 0 0 0 384 0 0 0 384 0 0 0 384 0 0 0 384 0 0 0 0 0 1 1 384 0 0 0 384 0 0 0 0 0 1 1 384 0 0 0
384 0 0 0 0 0 1 1 384 0 0 0 0 0 1 1 0 0 1 1 0 0 1 1 0 0 1 1 384 0 0 0 0 0 1 1 0 0 1 1 0 0 1 1 0 0 1 1 0 0 1 1 384 0 0 0 384 0 0 0 0 0 1 1 384 0 0 0 384 0 0 0 0 0 1 1 384 0 0 0
384 0 0 0 0 0 1 1 384 0 0 0 384 0 0 0 384 0 0 0 384 0 0 0 0 0 1 1 384 0 0 0 384 0 0 0 384 0 0 0 384 0 0 0 384 0 0 0 0 0 1 1 384 0 0 0 384 0 0 0 0 0 1 1 384 0 0 0 384 0 0 0 0 0 1 1 384 0 0 0
384 0 0 0 0 0 1 1 384 0 0 0 0 0 1 1 384 0 0 0 384 0 0 0 0 0 1 1 384 0 0 0 384 0 0 0 384 0 0 0 384 0 0 0 384 0 0 0 0 0 1 1 0 0 1 1 0 0 1 1 0 0 1 1 0 0 1 1 384 0 0 0 0 0 1 1 384 0 0 0
384 0 0 0 0 0 1 1 0 0 1 1 0 0 1 1 384 0 0 0 384 0 0 0 0 0 1 1 384 0 0 0 0 0 1 1 0 0 1 1 0 0 1 1 384 0 0 0 0 0 1 1 384 0 0 0 384 0 0 0 0 0 1 1 384 0 0 0 384 0 0 0 0 0 1 1 384 0 0 0
384 0 0 0 0 0 1 1 384 0 0 0 0 0 1 1 384 0 0 0 384 0 0 0 0 0 1 1 384 0 0 0 0 0 1 1 384 0 0 0 0 0 1 1 384 0 0 0 0 0 1 1 384 0 0 0 384 0 0 0 0 0 1 1 384 0 0 0 384 0 0 0 0 0 1 1 384 0 0 0
384 0 0 0 0 0 1 1 384 0 0 0 0 0 1 1 384 0 0 0 384 0 0 0 0 0 1 1 0 0 1 1 0 0 1 1 384 0 0 0 0 0 1 1 384 0 0 0 0 0 1 1 384 0 0 0 384 0 0 0 0 0 1 1 384 0 0 0 384 0 0 0 0 0 1 1 384 0 0 0
384 0 0 0 0 0 1 1 384 0 0 0 0 0 1 1 384 0 0 0 384 0 0 0 0 0 1 1 384 0 0 0 384 0 0 0 384 0 0 0 384 0 0 0 384 0 0 0 0 0 1 1 384 0 0 0 384 0 0 0 0 0 1 1 384 0 0 0 384 0 0 0 0 0 1 1 384 0 0 0
384 0 0 0 0 0 1 1 384 0 0 0 0 0 1 1 384 0 0 0 0 0 1 1 0 0 1 1 384 0 0 0 384 0 0 0 384 0 0 0 384 0 0 0 384 0 0 0 0 0 1 1 384 0 0 0 384 0 0 0 0 0 1 1 384 0 0 0 384 0 0 0 0 0 1 1 384 0 0 0
384 0 0 0 0 0 1 1 384 0 0 0 0 0 1 1 384 0 0 0 0 0 1 1 384 0 0 0 384 0 0 0 384 0 0 0 384 0 0 0 384 0 0 0 384 0 0 0 0 0 1 1 0 0 1 1 384 0 0 0 0 0 1 1 384 0 0 0 384 0 0 0 0 0 1 1 384 0 0 0
384 0 0 0 0 0 1 1 384 0 0 0 0 0 1 1 384 0 0 0 0 0 1 1 384 0 0 0 384 0 0 0 384 0 0 0 384 0 0 0 384 0 0 0 384 0 0 0 384 0 0 0 0 0 1 1 384 0 0 0 0 0 1 1 384 0 0 0 384 0 0 0 0 0 1 1 384 0 0 0
384 0 0 0 0 0 1 1 384 0 0 0 0 0 1 1 0 0 1 1 0 0 1 1 0 0 1 1 0 0 1 1 0 0 1 1 384 0 0 0 0 0 1 1 384 0 0 0 384 0 0 0 0 0 1 1 384 0 0 0 0 0 1 1 384 0 0 0 384 0 0 0 0 0 1 1 384 0 0 0
384 0 0 0 0 0 1 1 384 0 0 0 0 0 1 1 384 0 0 0 384 0 0 0 384 0 0 0 384 0 0 0 0 0 1 1 0 0 1 1 0 0 1 1 384 0 0 0 384 0 0 0 384 0 0 0 384 0 0 0 0 0 1 1 384 0 0 0 384 0 0 0 0 0 1 1 384 0 0 0
384 0 0 0 0 0 1 1 384 0 0 0 0 0 1 1 384 0 0 0 384 0 0 0 384 0 0 0 384 0 0 0 384 0 0 0 384 0 0 0 384 0 0 0 384 0 0 0 384 0 0 0 0 0 1 1 384 0 0 0 0 0 1 1 384 0 0 0 384 0 0 0 0 0 1 1 384 0 0 0
384 0 0 0 0 0 1 1 384 0 0 0 0 0 1 1 384 0 0 0 0 0 1 1 384 0 0 0 384 0 0 0 0 0 1 1 0 0 1 1 0 0 1 1 0 0 1 1 0 0 1 1 0 0 1 1 384 0 0 0 0 0 1 1 384 0 0 0 384 0 0 0 0 0 1 1 384 0 0 0
384 0 0 0 0 0 1 1 384 0 0 0 0 0 1 1 0 0 1 1 0 0 1 1 0 0 1 1 0 0 1 1 0 0 1 1 384 0 0 0 384 0 0 0 384 0 0 0 384 0 0 0 0 0 1 1 384 0 0 0 0 0 1 1 384 0 0 0 384 0 0 0 0 0 1 1 384 0 0 0
384 0 0 0 0 0 1 1 384 0 0 0 384 0 0 0 384 0 0 0 384 0 0 0 384 0 0 0 384 0 0 0 384 0 0 0 384 0 0 0 384 0 0 0 384 0 0 0 384 0 0 0 0 0 1 1 384 0 0 0 384 0 0 0 384 0 0 0 384 0 0 0 0 0 1 1 384 0 0 0
384 0 0 0 0 0 1 1 0 0 1 1 0 0 1 1 0 0 1 1 0 0 1 1 0 0 1 1 384 0 0 0 384 0 0 0 0 0 1 1 0 0 1 1 0 0 1 1 0 0 1 1 0 0 1 1 0 0 1 1 0 0 1 1 0 0 1 1 384 0 0 0 0 0 1 1 384 0 0 0
384 0 0 0 384 0 0 0 0 0 1 1 384 0 0 0 0 0 1 1 384 0 0 0 384 0 0 0 384 0 0 0 384 0 0 0 384 0 0 0 384 0 0 0 384 0 0 0 0 0 1 1 384 0 0 0 384 0 0 0 384 0 0 0 384 0 0 0 384 0 0 0 384 0 0 0 192 0 2 0
384 0 0 0 384 0 0 0 0 0 1 1 384 0 0 0 384 0 0 0 384 0 0 0 384 0 0 0 384 0 0 0 384 0 0 0 384 0 0 0 384 0 0 0 384 0 0 0 0 0 1 1 384 0 0 0 384 0 0 0 384 0 0 0 384 0 0 0 384 0 0 0 0 0 1 1 384 0 0 0
384 0 0 0 384 0 0 0 0 0 1 1 0 0 1 1 0 0 1 1 0 0 1 1 0 0 1 1 384 0 0 0 0 0 1 1 0 0 1 1 0 0 1 1 0 0 1 1 0 0 1 1 0 0 1 1 0 0 1 1 0 0 1 1 0 0 1 1 0 0 1 1 0 0 1 1 384 0 0 0
384 0 0 0 384 0 0 0 384 0 0 0 384 0 0 0 384 0 0 0 384 0 0 0 384 0 0 0 384 0 0 0 384 0 0 0 384 0 0 0 384 0 0 0 0 0 1 1 384 0 0 0 384 0 0 0 384 0 0 0 384 0 0 0 384 0 0 0 384 0 0 0 384 0 0 0 384 0 0 0
