64
40 40
1
Resourses//texturelevel.png
320 0 0 0 320 0 0 0 320 0 0 0 320 0 0 0 320 0 0 0 320 0 0 0 320 0 0 0 320 0 0 0 320 0 0 0 320 0 0 0 320 0 0 0 320 0 0 0 320 0 0 0 320 0 0 0 320 0 0 0 320 0 0 0 320 0 0 0 320 0 0 0 320 0 0 0 320 0 0 0 320 0 0 0 320 0 0 0 320 0 0 0 320 0 0 0 320 0 0 0 320 0 0 0 320 0 0 0 320 0 0 0 320 0 0 0 320 0 0 0 320 0 0 0 320 0 0 0 320 0 0 0 320 0 0 0 320 0 0 0 320 0 0 0 320 0 0 0 320 0 0 0 320 0 0 0 320 0 0 0
320 0 0 0 320 0 0 0 320 0 0 0 384 0 1 1 384 0 1 1 384 0 1 1 384 0 1 1 384 0 1 1 384 0 1 1 384 0 1 1 384 0 1 1 384 0 1 1 384 0 1 1 384 0 1 1 384 0 1 1 384 0 1 1 384 0 1 1 384 0 1 1 384 0 1 1 384 0 1 1 384 0 1 1 384 0 1 1 384 0 1 1 384 0 1 1 384 0 1 1 384 0 1 1 384 0 1 1 384 0 1 1 384 0 1 1 384 0 1 1 384 0 1 1 384 0 1 1 384 0 1 1 384 0 1 1 384 0 1 1 384 0 1 1 384 0 1 1 384 0 1 1 384 0 1 1 320 0 0 0
384 0 1 1 384 0 1 1 320 0 0 0 320 0 0 0 384 0 1 1 320 0 0 0 320 0 0 0 320 0 0 0 320 0 0 0 320 0 0 0 320 0 0 0 320 0 0 0 320 0 0 0 320 0 0 0 320 0 0 0 320 0 0 0 320 0 0 0 384 0 1 1 320 0 0 0 320 0 0 0 320 0 0 0 320 0 0 0 320 0 0 0 320 0 0 0 320 0 0 0 320 0 0 0 384 0 1 1 320 0 0 0 320 0 0 0 320 0 0 0 320 0 0 0 320 0 0 0 320 0 0 0 320 0 0 0 320 0 0 0 384 0 1 1 320 0 0 0 320 0 0 0 384 0 1 1 320 0 0 0
320 0 0 0 384 0 1 1 320 0 0 0 320 0 0 0 384 0 1 1 320 0 0 0 320 0 0 0 320 0 0 0 320 0 0 0 320 0 0 0 320 0 0 0 320 0 0 0 320 0 0 0 320 0 0 0 320 0 0 0 320 0 0 0 320 0 0 0 384 0 1 1 320 0 0 0 320 0 0 0 320 0 0 0 320 0 0 0 320 0 0 0 320 0 0 0 320 0 0 0 320 0 0 0 384 0 1 1 320 0 0 0 320 0 0 0 320 0 0 0 320 0 0 0 320 0 0 0 320 0 0 0 320 0 0 0 320 0 0 0 384 0 1 1 320 0 0 0 320 0 0 0 384 0 1 1 320 0 0 0
320 0 0 0 384 0 1 1 320 0 0 0 320 0 0 0 384 0 1 1 320 0 0 0 320 0 0 0 320 0 0 0 320 0 0 0 320 0 0 0 320 0 0 0 320 0 0 0 320 0 0 0 320 0 0 0 320 0 0 0 320 0 0 0 320 0 0 0 384 0 1 1 320 0 0 0 320 0 0 0 320 0 0 0 320 0 0 0 320 0 0 0 320 0 0 0 320 0 0 0 320 0 0 0 384 0 1 1 320 0 0 0 320 0 0 0 320 0 0 0 320 0 0 0 320 0 0 0 320 0 0 0 320 0 0 0 320 0 0 0 384 0 1 1 320 0 0 0 320 0 0 0 384 0 1 1 320 0 0 0
320 0 0 0 384 0 1 1 320 0 0 0 320 0 0 0 320 0 0 0 320 0 0 0 320 0 0 0 320 0 0 0 320 0 0 0 320 0 0 0 384 0 1 1 384 0 1 1 384 0 1 1 384 0 1 1 384 0 1 1 320 0 0 0 320 0 0 0 384 0 1 1 320 0 0 0 320 0 0 0 320 0 0 0 320 0 0 0 320 0 0 0 320 0 0 0 320 0 0 0 320 0 0 0 384 0 1 1 320 0 0 0 320 0 0 0 320 0 0 0 384 0 1 1 320 0 0 0 320 0 0 0 320 0 0 0 320 0 0 0 384 0 1 1 320 0 0 0 320 0 0 0 384 0 1 1 320 0 0 0
320 0 0 0 384 0 1 1 320 0 0 0 320 0 0 0 320 0 0 0 320 0 0 0 320 0 0 0 320 0 0 0 320 0 0 0 320 0 0 0 384 0 1 1 320 0 0 0 320 0 0 0 320 0 0 0 384 0 1 1 320 0 0 0 320 0 0 0 320 0 0 0 320 0 0 0 384 0 1 1 384 0 1 1 384 0 1 1 384 0 1 1 384 0 1 1 320 0 0 0 320 0 0 0 384 0 1 1 320 0 0 0 320 0 0 0 320 0 0 0 384 0 1 1 320 0 0 0 320 0 0 0 320 0 0 0 320 0 0 0 320 0 0 0 320 0 0 0 320 0 0 0 384 0 1 1 320 0 0 0
320 0 0 0 384 0 1 1 320 0 0 0 320 0 0 0 320 0 0 0 320 0 0 0 320 0 0 0 320 0 0 0 320 0 0 0 320 0 0 0 384 0 1 1 320 0 0 0 320 0 0 0 320 0 0 0 384 0 1 1 320 0 0 0 320 0 0 0 320 0 0 0 320 0 0 0 384 0 1 1 320 0 0 0 320 0 0 0 320 0 0 0 320 0 0 0 320 0 0 0 320 0 0 0 384 0 1 1 320 0 0 0 320 0 0 0 320 0 0 0 384 0 1 1 320 0 0 0 320 0 0 0 320 0 0 0 320 0 0 0 320 0 0 0 320 0 0 0 320 0 0 0 384 0 1 1 320 0 0 0
320 0 0 0 384 0 1 1 320 0 0 0 320 0 0 0 320 0 0 0 320 0 0 0 320 0 0 0 320 0 0 0 320 0 0 0 320 0 0 0 384 0 1 1 320 0 0 0 320 0 0 0 320 0 0 0 384 0 1 1 320 0 0 0 320 0 0 0 320 0 0 0 320 0 0 0 384 0 1 1 320 0 0 0 320 0 0 0 320 0 0 0 320 0 0 0 320 0 0 0 320 0 0 0 384 0 1 1 320 0 0 0 320 0 0 0 320 0 0 0 384 0 1 1 320 0 0 0 320 0 0 0 320 0 0 0 320 0 0 0 320 0 0 0 320 0 0 0 320 0 0 0 384 0 1 1 320 0 0 0
320 0 0 0 384 0 1 1 384 0 1 1 384 0 1 1 384 0 1 1 384 0 1 1 384 0 1 1 320 0 0 0 320 0 0 0 320 0 0 0 384 0 1 1 320 0 0 0 320 0 0 0 320 0 0 0 384 0 1 1 320 0 0 0 320 0 0 0 320 0 0 0 320 0 0 0 384 0 1 1 320 0 0 0 320 0 0 0 320 0 0 0 320 0 0 0 320 0 0 0 320 0 0 0 384 0 1 1 384 0 1 1 384 0 1 1 384 0 1 1 384 0 1 1 384 0 1 1 384 0 1 1 384 0 1 1 384 0 1 1 384 0 1 1 320 0 0 0 320 0 0 0 384 0 1 1 320 0 0 0
320 0 0 0 384 0 1 1 320 0 0 0 320 0 0 0 320 0 0 0 320 0 0 0 384 0 1 1 320 0 0 0 320 0 0 0 320 0 0 0 384 0 1 1 320 0 0 0 320 0 0 0 320 0 0 0 384 0 1 1 320 0 0 0 320 0 0 0 320 0 0 0 320 0 0 0 384 0 1 1 320 0 0 0 320 0 0 0 320 0 0 0 320 0 0 0 320 0 0 0 320 0 0 0 320 0 0 0 320 0 0 0 320 0 0 0 320 0 0 0 320 0 0 0 320 0 0 0 320 0 0 0 320 0 0 0 320 0 0 0 384 0 1 1 320 0 0 0 320 0 0 0 384 0 1 1 320 0 0 0
320 0 0 0 384 0 1 1 320 0 0 0 320 0 0 0 320 0 0 0 320 0 0 0 384 0 1 1 320 0 0 0 320 0 0 0 320 0 0 0 384 0 1 1 320 0 0 0 384 0 1 1 384 0 1 1 384 0 1 1 384 0 1 1 384 0 1 1 384 0 1 1 384 0 1 1 384 0 1 1 384 0 1 1 384 0 1 1 320 0 0 0 320 0 0 0 320 0 0 0 320 0 0 0 320 0 0 0 320 0 0 0 320 0 0 0 320 0 0 0 320 0 0 0 320 0 0 0 320 0 0 0 320 0 0 0 320 0 0 0 384 0 1 1 320 0 0 0 320 0 0 0 384 0 1 1 320 0 0 0
320 0 0 0 384 0 1 1 320 0 0 0 320 0 0 0 320 0 0 0 320 0 0 0 384 0 1 1 384 0 1 1 384 0 1 1 384 0 1 1 384 0 1 1 320 0 0 0 320 0 0 0 320 0 0 0 384 0 1 1 320 0 0 0 320 0 0 0 320 0 0 0 320 0 0 0 320 0 0 0 320 0 0 0 384 0 1 1 320 0 0 0 320 0 0 0 320 0 0 0 320 0 0 0 320 0 0 0 320 0 0 0 320 0 0 0 320 0 0 0 320 0 0 0 320 0 0 0 320 0 0 0 320 0 0 0 320 0 0 0 384 0 1 1 320 0 0 0 320 0 0 0 384 0 1 1 320 0 0 0
320 0 0 0 384 0 1 1 320 0 0 0 320 0 0 0 320 0 0 0 320 0 0 0 384 0 1 1 320 0 0 0 320 0 0 0 320 0 0 0 384 0 1 1 320 0 0 0 320 0 0 0 320 0 0 0 384 0 1 1 320 0 0 0 320 0 0 0 320 0 0 0 320 0 0 0 320 0 0 0 320 0 0 0 384 0 1 1 384 0 1 1 384 0 1 1 384 0 1 1 384 0 1 1 384 0 1 1 384 0 1 1 384 0 1 1 320 0 0 0 320 0 0 0 320 0 0 0 320 0 0 0 320 0 0 0 320 0 0 0 384 0 1 1 320 0 0 0 320 0 0 0 384 0 1 1 320 0 0 0
320 0 0 0 384 0 1 1 320 0 0 0 320 0 0 0 320 0 0 0 320 0 0 0 384 0 1 1 320 0 0 0 320 0 0 0 320 0 0 0 384 0 1 1 320 0 0 0 320 0 0 0 320 0 0 0 384 0 1 1 320 0 0 0 320 0 0 0 320 0 0 0 320 0 0 0 320 0 0 0 320 0 0 0 320 0 0 0 320 0 0 0 320 0 0 0 320 0 0 0 320 0 0 0 320 0 0 0 320 0 0 0 320 0 0 0 320 0 0 0 320 0 0 0 320 0 0 0 320 0 0 0 384 0 1 1 320 0 0 0 320 0 0 0 320 0 0 0 320 0 0 0 384 0 1 1 320 0 0 0
320 0 0 0 384 0 1 1 320 0 0 0 320 0 0 0 320 0 0 0 320 0 0 0 384 0 1 1 320 0 0 0 320 0 0 0 320 0 0 0 384 0 1 1 320 0 0 0 320 0 0 0 320 0 0 0 384 0 1 1 320 0 0 0 320 0 0 0 320 0 0 0 320 0 0 0 320 0 0 0 320 0 0 0 320 0 0 0 320 0 0 0 384 0 1 1 384 0 1 1 384 0 1 1 384 0 1 1 384 0 1 1 384 0 1 1 384 0 1 1 384 0 1 1 320 0 0 0 320 0 0 0 384 0 1 1 320 0 0 0 320 0 0 0 320 0 0 0 320 0 0 0 384 0 1 1 320 0 0 0
320 0 0 0 384 0 1 1 320 0 0 0 320 0 0 0 320 0 0 0 320 0 0 0 384 0 1 1 320 0 0 0 384 0 1 1 320 0 0 0 320 0 0 0 320 0 0 0 320 0 0 0 320 0 0 0 320 0 0 0 320 0 0 0 320 0 0 0 320 0 0 0 320 0 0 0 320 0 0 0 320 0 0 0 320 0 0 0 320 0 0 0 320 0 0 0 320 0 0 0 320 0 0 0 320 0 0 0 320 0 0 0 320 0 0 0 320 0 0 0 384 0 1 1 320 0 0 0 320 0 0 0 384 0 1 1 320 0 0 0 320 0 0 0 320 0 0 0 320 0 0 0 384 0 1 1 320 0 0 0
384 0 1 1 384 0 1 1 320 0 0 0 320 0 0 0 320 0 0 0 320 0 0 0 384 0 1 1 320 0 0 0 384 0 1 1 320 0 0 0 320 0 0 0 320 0 0 0 320 0 0 0 320 0 0 0 320 0 0 0 320 0 0 0 320 0 0 0 320 0 0 0 320 0 0 0 320 0 0 0 320 0 0 0 320 0 0 0 320 0 0 0 320 0 0 0 320 0 0 0 320 0 0 0 320 0 0 0 320 0 0 0 320 0 0 0 320 0 0 0 384 0 1 1 320 0 0 0 320 0 0 0 384 0 1 1 320 0 0 0 320 0 0 0 320 0 0 0 320 0 0 0 384 0 1 1 320 0 0 0
384 0 1 1 320 0 0 0 320 0 0 0 320 0 0 0 320 0 0 0 320 0 0 0 384 0 1 1 320 0 0 0 384 0 1 1 320 0 0 0 320 0 0 0 320 0 0 0 384 0 1 1 384 0 1 1 384 0 1 1 384 0 1 1 384 0 1 1 384 0 1 1 384 0 1 1 384 0 1 1 384 0 1 1 384 0 1 1 384 0 1 1 384 0 1 1 384 0 1 1 384 0 1 1 320 0 0 0 320 0 0 0 320 0 0 0 320 0 0 0 384 0 1 1 320 0 0 0 320 0 0 0 384 0 1 1 320 0 0 0 320 0 0 0 320 0 0 0 320 0 0 0 384 0 1 1 320 0 0 0
384 0 1 1 320 0 0 0 320 0 0 0 320 0 0 0 320 0 0 0 320 0 0 0 384 0 1 1 320 0 0 0 384 0 1 1 320 0 0 0 320 0 0 0 320 0 0 0 384 0 1 1 320 0 0 0 320 0 0 0 320 0 0 0 384 0 1 1 320 0 0 0 320 0 0 0 320 0 0 0 320 0 0 0 320 0 0 0 320 0 0 0 320 0 0 0 320 0 0 0 384 0 1 1 320 0 0 0 320 0 0 0 320 0 0 0 384 0 1 1 384 0 1 1 384 0 1 1 384 0 1 1 384 0 1 1 384 0 1 1 384 0 1 1 384 0 1 1 384 0 1 1 384 0 1 1 320 0 0 0
384 0 1 1 384 0 1 1 320 0 0 0 320 0 0 0 320 0 0 0 320 0 0 0 384 0 1 1 320 0 0 0 384 0 1 1 384 0 1 1 384 0 1 1 384 0 1 1 384 0 1 1 320 0 0 0 320 0 0 0 320 0 0 0 384 0 1 1 320 0 0 0 320 0 0 0 320 0 0 0 320 0 0 0 320 0 0 0 320 0 0 0 320 0 0 0 320 0 0 0 384 0 1 1 320 0 0 0 320 0 0 0 320 0 0 0 320 0 0 0 320 0 0 0 320 0 0 0 320 0 0 0 320 0 0 0 320 0 0 0 320 0 0 0 320 0 0 0 320 0 0 0 384 0 1 1 320 0 0 0
320 0 0 0 384 0 1 1 320 0 0 0 320 0 0 0 320 0 0 0 320 0 0 0 384 0 1 1 320 0 0 0 320 0 0 0 320 0 0 0 320 0 0 0 320 0 0 0 320 0 0 0 320 0 0 0 320 0 0 0 320 0 0 0 384 0 1 1 320 0 0 0 320 0 0 0 320 0 0 0 320 0 0 0 320 0 0 0 384 0 1 1 384 0 1 1 384 0 1 1 384 0 1 1 384 0 1 1 384 0 1 1 384 0 1 1 320 0 0 0 320 0 0 0 320 0 0 0 320 0 0 0 320 0 0 0 320 0 0 0 320 0 0 0 320 0 0 0 320 0 0 0 384 0 1 1 320 0 0 0
320 0 0 0 384 0 1 1 320 0 0 0 320 0 0 0 320 0 0 0 320 0 0 0 384 0 1 1 320 0 0 0 320 0 0 0 320 0 0 0 320 0 0 0 320 0 0 0 320 0 0 0 320 0 0 0 320 0 0 0 320 0 0 0 384 0 1 1 320 0 0 0 320 0 0 0 320 0 0 0 320 0 0 0 320 0 0 0 384 0 1 1 320 0 0 0 320 0 0 0 320 0 0 0 320 0 0 0 320 0 0 0 320 0 0 0 320 0 0 0 320 0 0 0 320 0 0 0 320 0 0 0 384 0 1 1 320 0 0 0 320 0 0 0 320 0 0 0 320 0 0 0 384 0 1 1 320 0 0 0
320 0 0 0 384 0 1 1 320 0 0 0 320 0 0 0 320 0 0 0 320 0 0 0 384 0 1 1 320 0 0 0 320 0 0 0 320 0 0 0 320 0 0 0 320 0 0 0 320 0 0 0 320 0 0 0 320 0 0 0 320 0 0 0 384 0 1 1 384 0 1 1 384 0 1 1 384 0 1 1 320 0 0 0 320 0 0 0 384 0 1 1 320 0 0 0 320 0 0 0 320 0 0 0 320 0 0 0 320 0 0 0 320 0 0 0 320 0 0 0 320 0 0 0 320 0 0 0 320 0 0 0 384 0 1 1 320 0 0 0 320 0 0 0 320 0 0 0 320 0 0 0 384 0 1 1 320 0 0 0
320 0 0 0 384 0 1 1 320 0 0 0 320 0 0 0 384 0 1 1 384 0 1 1 384 0 1 1 320 0 0 0 320 0 0 0 320 0 0 0 320 0 0 0 320 0 0 0 320 0 0 0 320 0 0 0 320 0 0 0 320 0 0 0 320 0 0 0 320 0 0 0 320 0 0 0 384 0 1 1 320 0 0 0 320 0 0 0 384 0 1 1 320 0 0 0 320 0 0 0 320 0 0 0 384 0 1 1 384 0 1 1 384 0 1 1 384 0 1 1 384 0 1 1 384 0 1 1 384 0 1 1 384 0 1 1 384 0 1 1 384 0 1 1 384 0 1 1 384 0 1 1 384 0 1 1 320 0 0 0
320 0 0 0 384 0 1 1 320 0 0 0 320 0 0 0 320 0 0 0 320 0 0 0 384 0 1 1 320 0 0 0 320 0 0 0 320 0 0 0 320 0 0 0 320 0 0 0 320 0 0 0 384 0 1 1 320 0 0 0 320 0 0 0 320 0 0 0 320 0 0 0 320 0 0 0 384 0 1 1 320 0 0 0 320 0 0 0 384 0 1 1 320 0 0 0 320 0 0 0 320 0 0 0 384 0 1 1 320 0 0 0 320 0 0 0 320 0 0 0 320 0 0 0 320 0 0 0 320 0 0 0 320 0 0 0 320 0 0 0 384 0 1 1 320 0 0 0 320 0 0 0 384 0 1 1 320 0 0 0
320 0 0 0 384 0 1 1 320 0 0 0 320 0 0 0 320 0 0 0 320 0 0 0 384 0 1 1 384 0 1 1 384 0 1 1 384 0 1 1 384 0 1 1 320 0 0 0 320 0 0 0 384 0 1 1 320 0 0 0 320 0 0 0 320 0 0 0 320 0 0 0 320 0 0 0 320 0 0 0 320 0 0 0 320 0 0 0 384 0 1 1 320 0 0 0 320 0 0 0 320 0 0 0 384 0 1 1 320 0 0 0 320 0 0 0 320 0 0 0 320 0 0 0 320 0 0 0 320 0 0 0 320 0 0 0 320 0 0 0 384 0 1 1 320 0 0 0 320 0 0 0 384 0 1 1 320 0 0 0
320 0 0 0 384 0 1 1 320 0 0 0 320 0 0 0 320 0 0 0 320 0 0 0 320 0 0 0 320 0 0 0 320 0 0 0 320 0 0 0 320 0 0 0 320 0 0 0 320 0 0 0 384 0 1 1 320 0 0 0 320 0 0 0 320 0 0 0 320 0 0 0 320 0 0 0 320 0 0 0 320 0 0 0 320 0 0 0 384 0 1 1 320 0 0 0 320 0 0 0 320 0 0 0 384 0 1 1 320 0 0 0 320 0 0 0 320 0 0 0 320 0 0 0 320 0 0 0 320 0 0 0 320 0 0 0 320 0 0 0 384 0 1 1 320 0 0 0 320 0 0 0 384 0 1 1 320 0 0 0
320 0 0 0 384 0 1 1 320 0 0 0 320 0 0 0 320 0 0 0 320 0 0 0 320 0 0 0 320 0 0 0 320 0 0 0 320 0 0 0 320 0 0 0 320 0 0 0 320 0 0 0 384 0 1 1 320 0 0 0 320 0 0 0 320 0 0 0 320 0 0 0 320 0 0 0 320 0 0 0 320 0 0 0 320 0 0 0 384 0 1 1 320 0 0 0 320 0 0 0 320 0 0 0 384 0 1 1 320 0 0 0 320 0 0 0 320 0 0 0 320 0 0 0 320 0 0 0 320 0 0 0 320 0 0 0 320 0 0 0 384 0 1 1 320 0 0 0 320 0 0 0 384 0 1 1 320 0 0 0
320 0 0 0 384 0 1 1 320 0 0 0 320 0 0 0 320 0 0 0 320 0 0 0 384 0 1 1 384 0 1 1 384 0 1 1 384 0 1 1 384 0 1 1 384 0 1 1 384 0 1 1 384 0 1 1 384 0 1 1 384 0 1 1 384 0 1 1 384 0 1 1 384 0 1 1 384 0 1 1 384 0 1 1 384 0 1 1 384 0 1 1 320 0 0 0 320 0 0 0 320 0 0 0 384 0 1 1 320 0 0 0 320 0 0 0 320 0 0 0 320 0 0 0 384 0 1 1 320 0 0 0 320 0 0 0 320 0 0 0 384 0 1 1 320 0 0 0 320 0 0 0 384 0 1 1 320 0 0 0
320 0 0 0 384 0 1 1 320 0 0 0 320 0 0 0 320 0 0 0 320 0 0 0 320 0 0 0 384 0 1 1 320 0 0 0 320 0 0 0 320 0 0 0 320 0 0 0 320 0 0 0 320 0 0 0 320 0 0 0 320 0 0 0 320 0 0 0 320 0 0 0 320 0 0 0 320 0 0 0 320 0 0 0 320 0 0 0 384 0 1 1 320 0 0 0 320 0 0 0 320 0 0 0 384 0 1 1 320 0 0 0 320 0 0 0 320 0 0 0 320 0 0 0 384 0 1 1 320 0 0 0 320 0 0 0 320 0 0 0 384 0 1 1 320 0 0 0 320 0 0 0 384 0 1 1 320 0 0 0
320 0 0 0 384 0 1 1 384 0 1 1 384 0 1 1 384 0 1 1 320 0 0 0 320 0 0 0 384 0 1 1 320 0 0 0 384 0 1 1 320 0 0 0 320 0 0 0 320 0 0 0 320 0 0 0 320 0 0 0 320 0 0 0 320 0 0 0 320 0 0 0 320 0 0 0 320 0 0 0 320 0 0 0 320 0 0 0 384 0 1 1 320 0 0 0 320 0 0 0 320 0 0 0 320 0 0 0 320 0 0 0 320 0 0 0 320 0 0 0 320 0 0 0 384 0 1 1 320 0 0 0 320 0 0 0 320 0 0 0 384 0 1 1 320 0 0 0 320 0 0 0 384 0 1 1 320 0 0 0
320 0 0 0 384 0 1 1 320 0 0 0 320 0 0 0 320 0 0 0 320 0 0 0 384 0 1 1 384 0 1 1 320 0 0 0 384 0 1 1 320 0 0 0 320 0 0 0 320 0 0 0 320 0 0 0 320 0 0 0 320 0 0 0 384 0 1 1 320 0 0 0 320 0 0 0 320 0 0 0 320 0 0 0 320 0 0 0 384 0 1 1 384 0 1 1 384 0 1 1 384 0 1 1 384 0 1 1 384 0 1 1 384 0 1 1 384 0 1 1 384 0 1 1 384 0 1 1 320 0 0 0 320 0 0 0 320 0 0 0 384 0 1 1 320 0 0 0 320 0 0 0 384 0 1 1 320 0 0 0
320 0 0 0 384 0 1 1 320 0 0 0 320 0 0 0 320 0 0 0 320 0 0 0 320 0 0 0 320 0 0 0 320 0 0 0 384 0 1 1 320 0 0 0 320 0 0 0 320 0 0 0 320 0 0 0 320 0 0 0 320 0 0 0 384 0 1 1 320 0 0 0 320 0 0 0 320 0 0 0 320 0 0 0 320 0 0 0 384 0 1 1 320 0 0 0 320 0 0 0 320 0 0 0 320 0 0 0 320 0 0 0 320 0 0 0 320 0 0 0 320 0 0 0 384 0 1 1 320 0 0 0 320 0 0 0 320 0 0 0 320 0 0 0 320 0 0 0 320 0 0 0 384 0 1 1 320 0 0 0
320 0 0 0 384 0 1 1 320 0 0 0 320 0 0 0 320 0 0 0 320 0 0 0 320 0 0 0 320 0 0 0 320 0 0 0 384 0 1 1 320 0 0 0 320 0 0 0 320 0 0 0 320 0 0 0 320 0 0 0 320 0 0 0 384 0 1 1 320 0 0 0 320 0 0 0 320 0 0 0 320 0 0 0 320 0 0 0 384 0 1 1 320 0 0 0 320 0 0 0 320 0 0 0 320 0 0 0 320 0 0 0 320 0 0 0 320 0 0 0 320 0 0 0 384 0 1 1 384 0 1 1 384 0 1 1 384 0 1 1 320 0 0 0 320 0 0 0 320 0 0 0 384 0 1 1 320 0 0 0
320 0 0 0 384 0 1 1 384 0 1 1 384 0 1 1 384 0 1 1 384 0 1 1 384 0 1 1 384 0 1 1 384 0 1 1 384 0 1 1 320 0 0 0 320 0 0 0 320 0 0 0 384 0 1 1 384 0 1 1 384 0 1 1 384 0 1 1 320 0 0 0 320 0 0 0 320 0 0 0 320 0 0 0 320 0 0 0 384 0 1 1 320 0 0 0 320 0 0 0 320 0 0 0 320 0 0 0 320 0 0 0 320 0 0 0 320 0 0 0 320 0 0 0 320 0 0 0 320 0 0 0 320 0 0 0 320 0 0 0 320 0 0 0 320 0 0 0 320 0 0 0 384 0 1 1 320 0 0 0
320 0 0 0 384 0 1 1 320 0 0 0 320 0 0 0 320 0 0 0 320 0 0 0 320 0 0 0 320 0 0 0 320 0 0 0 320 0 0 0 320 0 0 0 320 0 0 0 320 0 0 0 320 0 0 0 320 0 0 0 320 0 0 0 384 0 1 1 320 0 0 0 320 0 0 0 320 0 0 0 320 0 0 0 320 0 0 0 384 0 1 1 384 0 1 1 384 0 1 1 384 0 1 1 384 0 1 1 384 0 1 1 320 0 0 0 320 0 0 0 320 0 0 0 320 0 0 0 320 0 0 0 320 0 0 0 320 0 0 0 320 0 0 0 320 0 0 0 320 0 0 0 384 0 1 1 320 0 0 0
320 0 0 0 384 0 1 1 320 0 0 0 320 0 0 0 320 0 0 0 320 0 0 0 320 0 0 0 320 0 0 0 320 0 0 0 320 0 0 0 320 0 0 0 320 0 0 0 320 0 0 0 320 0 0 0 320 0 0 0 320 0 0 0 384 0 1 1 320 0 0 0 320 0 0 0 320 0 0 0 320 0 0 0 320 0 0 0 320 0 0 0 320 0 0 0 320 0 0 0 320 0 0 0 320 0 0 0 320 0 0 0 320 0 0 0 320 0 0 0 320 0 0 0 320 0 0 0 320 0 0 0 320 0 0 0 320 0 0 0 320 0 0 0 320 0 0 0 320 0 0 0 576 0 2 0 320 0 0 0
320 0 0 0 384 0 1 1 384 0 1 1 384 0 1 1 384 0 1 1 384 0 1 1 384 0 1 1 384 0 1 1 384 0 1 1 384 0 1 1 384 0 1 1 384 0 1 1 384 0 1 1 384 0 1 1 384 0 1 1 384 0 1 1 384 0 1 1 384 0 1 1 384 0 1 1 320 0 0 0 384 0 1 1 384 0 1 1 384 0 1 1 384 0 1 1 384 0 1 1 384 0 1 1 384 0 1 1 384 0 1 1 384 0 1 1 384 0 1 1 384 0 1 1 384 0 1 1 384 0 1 1 384 0 1 1 384 0 1 1 384 0 1 1 384 0 1 1 384 0 1 1 384 0 1 1 320 0 0 0
320 0 0 0 320 0 0 0 320 0 0 0 320 0 0 0 320 0 0 0 320 0 0 0 320 0 0 0 320 0 0 0 320 0 0 0 320 0 0 0 320 0 0 0 320 0 0 0 320 0 0 0 320 0 0 0 320 0 0 0 320 0 0 0 320 0 0 0 384 0 1 1 320 0 0 0 320 0 0 0 384 0 1 1 320 0 0 0 320 0 0 0 320 0 0 0 320 0 0 0 320 0 0 0 320 0 0 0 320 0 0 0 320 0 0 0 320 0 0 0 320 0 0 0 320 0 0 0 320 0 0 0 320 0 0 0 320 0 0 0 320 0 0 0 320 0 0 0 320 0 0 0 320 0 0 0 320 0 0 0