64
50 50
1
Resourses//firstlevel.png
576 0 0 0 320 0 1 1 576 0 0 0 576 0 0 0 576 0 0 0 576 0 0 0 576 0 0 0 576 0 0 0 576 0 0 0 576 0 0 0 576 0 0 0 576 0 0 0 576 0 0 0 576 0 0 0 576 0 0 0 576 0 0 0 576 0 0 0 576 0 0 0 576 0 0 0 576 0 0 0 576 0 0 0 576 0 0 0 576 0 0 0 576 0 0 0 576 0 0 0 576 0 0 0 576 0 0 0 576 0 0 0 576 0 0 0 576 0 0 0 576 0 0 0 576 0 0 0 576 0 0 0 576 0 0 0 576 0 0 0 576 0 0 0 576 0 0 0 576 0 0 0 576 0 0 0 576 0 0 0 576 0 0 0 576 0 0 0 576 0 0 0 576 0 0 0 576 0 0 0 576 0 0 0 576 0 0 0 576 0 0 0 576 0 0 0 576 0 0 0
576 0 0 0 320 0 1 1 320 0 1 1 320 0 1 1 320 0 1 1 320 0 1 1 320 0 1 1 320 0 1 1 320 0 1 1 320 0 1 1 320 0 1 1 320 0 1 1 320 0 1 1 320 0 1 1 320 0 1 1 320 0 1 1 320 0 1 1 320 0 1 1 320 0 1 1 320 0 1 1 320 0 1 1 320 0 1 1 320 0 1 1 320 0 1 1 320 0 1 1 320 0 1 1 320 0 1 1 320 0 1 1 320 0 1 1 320 0 1 1 320 0 1 1 320 0 1 1 320 0 1 1 320 0 1 1 320 0 1 1 320 0 1 1 320 0 1 1 320 0 1 1 320 0 1 1 320 0 1 1 320 0 1 1 320 0 1 1 320 0 1 1 320 0 1 1 320 0 1 1 320 0 1 1 320 0 1 1 320 0 1 1 320 0 1 1 576 0 0 0
576 0 0 0 320 0 1 1 576 0 0 0 576 0 0 0 576 0 0 0 576 0 0 0 576 0 0 0 576 0 0 0 576 0 0 0 576 0 0 0 576 0 0 0 576 0 0 0 576 0 0 0 320 0 1 1 576 0 0 0 576 0 0 0 576 0 0 0 320 0 1 1 576 0 0 0 576 0 0 0 576 0 0 0 320 0 1 1 576 0 0 0 576 0 0 0 576 0 0 0 576 0 0 0 576 0 0 0 576 0 0 0 576 0 0 0 576 0 0 0 576 0 0 0 576 0 0 0 576 0 0 0 576 0 0 0 576 0 0 0 576 0 0 0 320 0 1 1 576 0 0 0 576 0 0 0 320 0 1 1 576 0 0 0 576 0 0 0 320 0 1 1 576 0 0 0 576 0 0 0 576 0 0 0 576 0 0 0 576 0 0 0 320 0 1 1 576 0 0 0
576 0 0 0 576 0 0 0 576 0 0 0 320 0 1 1 320 0 1 1 320 0 1 1 320 0 1 1 320 0 1 1 320 0 1 1 320 0 1 1 320 0 1 1 320 0 1 1 320 0 1 1 320 0 1 1 320 0 1 1 320 0 1 1 576 0 0 0 320 0 1 1 576 0 0 0 576 0 0 0 576 0 0 0 320 0 1 1 320 0 1 1 320 0 1 1 320 0 1 1 576 0 0 0 576 0 0 0 576 0 0 0 576 0 0 0 576 0 0 0 320 0 1 1 320 0 1 1 320 0 1 1 320 0 1 1 320 0 1 1 320 0 1 1 320 0 1 1 576 0 0 0 576 0 0 0 320 0 1 1 576 0 0 0 576 0 0 0 320 0 1 1 576 0 0 0 320 0 1 1 320 0 1 1 320 0 1 1 576 0 0 0 320 0 1 1 576 0 0 0
576 0 0 0 576 0 0 0 576 0 0 0 320 0 1 1 576 0 0 0 576 0 0 0 576 0 0 0 576 0 0 0 576 0 0 0 576 0 0 0 576 0 0 0 576 0 0 0 576 0 0 0 320 0 1 1 576 0 0 0 320 0 1 1 576 0 0 0 320 0 1 1 576 0 0 0 320 0 1 1 576 0 0 0 576 0 0 0 576 0 0 0 576 0 0 0 320 0 1 1 320 0 1 1 576 0 0 0 576 0 0 0 576 0 0 0 576 0 0 0 320 0 1 1 576 0 0 0 576 0 0 0 576 0 0 0 576 0 0 0 576 0 0 0 576 0 0 0 576 0 0 0 576 0 0 0 320 0 1 1 576 0 0 0 576 0 0 0 320 0 1 1 576 0 0 0 320 0 1 1 576 0 0 0 320 0 1 1 576 0 0 0 320 0 1 1 576 0 0 0
576 0 0 0 320 0 1 1 576 0 0 0 576 0 0 0 576 0 0 0 320 0 1 1 320 0 1 1 320 0 1 1 320 0 1 1 320 0 1 1 320 0 1 1 576 0 0 0 576 0 0 0 320 0 1 1 576 0 0 0 320 0 1 1 576 0 0 0 320 0 1 1 320 0 1 1 320 0 1 1 576 0 0 0 576 0 0 0 576 0 0 0 576 0 0 0 576 0 0 0 320 0 1 1 320 0 1 1 320 0 1 1 576 0 0 0 576 0 0 0 320 0 1 1 576 0 0 0 576 0 0 0 576 0 0 0 576 0 0 0 576 0 0 0 576 0 0 0 576 0 0 0 320 0 1 1 320 0 1 1 576 0 0 0 576 0 0 0 320 0 1 1 576 0 0 0 320 0 1 1 576 0 0 0 320 0 1 1 576 0 0 0 320 0 1 1 576 0 0 0
576 0 0 0 320 0 1 1 576 0 0 0 576 0 0 0 576 0 0 0 576 0 0 0 576 0 0 0 576 0 0 0 576 0 0 0 576 0 0 0 320 0 1 1 576 0 0 0 576 0 0 0 320 0 1 1 576 0 0 0 576 0 0 0 576 0 0 0 576 0 0 0 576 0 0 0 576 0 0 0 576 0 0 0 576 0 0 0 576 0 0 0 576 0 0 0 576 0 0 0 320 0 1 1 576 0 0 0 576 0 0 0 576 0 0 0 576 0 0 0 320 0 1 1 576 0 0 0 320 0 1 1 320 0 1 1 320 0 1 1 320 0 1 1 320 0 1 1 576 0 0 0 576 0 0 0 576 0 0 0 576 0 0 0 576 0 0 0 320 0 1 1 576 0 0 0 320 0 1 1 576 0 0 0 320 0 1 1 576 0 0 0 320 0 1 1 576 0 0 0
576 0 0 0 320 0 1 1 576 0 0 0 320 0 1 1 320 0 1 1 320 0 1 1 320 0 1 1 320 0 1 1 320 0 1 1 320 0 1 1 320 0 1 1 576 0 0 0 576 0 0 0 320 0 1 1 576 0 0 0 576 0 0 0 576 0 0 0 576 0 0 0 576 0 0 0 576 0 0 0 576 0 0 0 576 0 0 0 576 0 0 0 576 0 0 0 576 0 0 0 576 0 0 0 576 0 0 0 576 0 0 0 576 0 0 0 576 0 0 0 320 0 1 1 576 0 0 0 320 0 1 1 576 0 0 0 576 0 0 0 576 0 0 0 320 0 1 1 576 0 0 0 576 0 0 0 576 0 0 0 576 0 0 0 576 0 0 0 320 0 1 1 576 0 0 0 320 0 1 1 576 0 0 0 320 0 1 1 576 0 0 0 320 0 1 1 576 0 0 0
576 0 0 0 320 0 1 1 576 0 0 0 576 0 0 0 576 0 0 0 576 0 0 0 576 0 0 0 576 0 0 0 576 0 0 0 576 0 0 0 320 0 1 1 576 0 0 0 576 0 0 0 320 0 1 1 320 0 1 1 320 0 1 1 320 0 1 1 320 0 1 1 320 0 1 1 320 0 1 1 320 0 1 1 320 0 1 1 320 0 1 1 320 0 1 1 320 0 1 1 320 0 1 1 320 0 1 1 320 0 1 1 320 0 1 1 320 0 1 1 320 0 1 1 576 0 0 0 320 0 1 1 576 0 0 0 576 0 0 0 576 0 0 0 320 0 1 1 576 0 0 0 320 0 1 1 320 0 1 1 320 0 1 1 320 0 1 1 320 0 1 1 576 0 0 0 320 0 1 1 576 0 0 0 320 0 1 1 576 0 0 0 320 0 1 1 576 0 0 0
576 0 0 0 320 0 1 1 576 0 0 0 320 0 1 1 320 0 1 1 320 0 1 1 320 0 1 1 320 0 1 1 320 0 1 1 576 0 0 0 320 0 1 1 576 0 0 0 576 0 0 0 576 0 0 0 576 0 0 0 576 0 0 0 576 0 0 0 576 0 0 0 576 0 0 0 576 0 0 0 576 0 0 0 320 0 1 1 576 0 0 0 576 0 0 0 576 0 0 0 576 0 0 0 576 0 0 0 576 0 0 0 576 0 0 0 576 0 0 0 576 0 0 0 576 0 0 0 320 0 1 1 576 0 0 0 576 0 0 0 576 0 0 0 320 0 1 1 576 0 0 0 320 0 1 1 576 0 0 0 576 0 0 0 576 0 0 0 576 0 0 0 576 0 0 0 320 0 1 1 576 0 0 0 320 0 1 1 576 0 0 0 320 0 1 1 576 0 0 0
576 0 0 0 320 0 1 1 576 0 0 0 320 0 1 1 576 0 0 0 576 0 0 0 576 0 0 0 576 0 0 0 320 0 1 1 576 0 0 0 320 0 1 1 576 0 0 0 576 0 0 0 576 0 0 0 576 0 0 0 576 0 0 0 576 0 0 0 576 0 0 0 576 0 0 0 576 0 0 0 576 0 0 0 320 0 1 1 576 0 0 0 576 0 0 0 320 0 1 1 320 0 1 1 320 0 1 1 320 0 1 1 320 0 1 1 320 0 1 1 320 0 1 1 320 0 1 1 320 0 1 1 576 0 0 0 576 0 0 0 576 0 0 0 320 0 1 1 576 0 0 0 320 0 1 1 576 0 0 0 320 0 1 1 320 0 1 1 320 0 1 1 320 0 1 1 320 0 1 1 576 0 0 0 320 0 1 1 576 0 0 0 320 0 1 1 576 0 0 0
576 0 0 0 320 0 1 1 576 0 0 0 320 0 1 1 320 0 1 1 576 0 0 0 320 0 1 1 576 0 0 0 320 0 1 1 576 0 0 0 320 0 1 1 576 0 0 0 576 0 0 0 320 0 1 1 320 0 1 1 320 0 1 1 320 0 1 1 320 0 1 1 320 0 1 1 576 0 0 0 576 0 0 0 320 0 1 1 576 0 0 0 576 0 0 0 320 0 1 1 576 0 0 0 576 0 0 0 576 0 0 0 576 0 0 0 576 0 0 0 576 0 0 0 576 0 0 0 576 0 0 0 576 0 0 0 320 0 1 1 320 0 1 1 320 0 1 1 320 0 1 1 320 0 1 1 576 0 0 0 320 0 1 1 576 0 0 0 576 0 0 0 576 0 0 0 576 0 0 0 576 0 0 0 320 0 1 1 576 0 0 0 320 0 1 1 576 0 0 0
320 0 1 1 320 0 1 1 576 0 0 0 576 0 0 0 320 0 1 1 576 0 0 0 320 0 1 1 576 0 0 0 320 0 1 1 576 0 0 0 320 0 1 1 576 0 0 0 576 0 0 0 320 0 1 1 576 0 0 0 576 0 0 0 576 0 0 0 576 0 0 0 320 0 1 1 576 0 0 0 576 0 0 0 320 0 1 1 576 0 0 0 576 0 0 0 320 0 1 1 576 0 0 0 576 0 0 0 576 0 0 0 576 0 0 0 576 0 0 0 576 0 0 0 576 0 0 0 576 0 0 0 576 0 0 0 320 0 1 1 576 0 0 0 576 0 0 0 576 0 0 0 576 0 0 0 576 0 0 0 320 0 1 1 320 0 1 1 320 0 1 1 320 0 1 1 320 0 1 1 576 0 0 0 320 0 1 1 576 0 0 0 320 0 1 1 576 0 0 0
576 0 0 0 320 0 1 1 576 0 0 0 576 0 0 0 320 0 1 1 576 0 0 0 320 0 1 1 576 0 0 0 320 0 1 1 576 0 0 0 320 0 1 1 576 0 0 0 576 0 0 0 320 0 1 1 320 0 1 1 320 0 1 1 320 0 1 1 576 0 0 0 320 0 1 1 576 0 0 0 576 0 0 0 320 0 1 1 576 0 0 0 576 0 0 0 576 0 0 0 576 0 0 0 576 0 0 0 320 0 1 1 576 0 0 0 576 0 0 0 576 0 0 0 576 0 0 0 576 0 0 0 576 0 0 0 320 0 1 1 576 0 0 0 576 0 0 0 576 0 0 0 576 0 0 0 576 0 0 0 576 0 0 0 576 0 0 0 576 0 0 0 576 0 0 0 576 0 0 0 576 0 0 0 320 0 1 1 576 0 0 0 320 0 1 1 576 0 0 0
576 0 0 0 320 0 1 1 576 0 0 0 576 0 0 0 320 0 1 1 576 0 0 0 320 0 1 1 576 0 0 0 320 0 1 1 576 0 0 0 320 0 1 1 576 0 0 0 576 0 0 0 576 0 0 0 576 0 0 0 576 0 0 0 576 0 0 0 576 0 0 0 320 0 1 1 576 0 0 0 576 0 0 0 320 0 1 1 576 0 0 0 576 0 0 0 576 0 0 0 576 0 0 0 576 0 0 0 320 0 1 1 576 0 0 0 576 0 0 0 320 0 1 1 320 0 1 1 320 0 1 1 320 0 1 1 320 0 1 1 576 0 0 0 576 0 0 0 576 0 0 0 320 0 1 1 320 0 1 1 320 0 1 1 320 0 1 1 320 0 1 1 320 0 1 1 320 0 1 1 576 0 0 0 320 0 1 1 576 0 0 0 320 0 1 1 576 0 0 0
576 0 0 0 320 0 1 1 576 0 0 0 576 0 0 0 320 0 1 1 576 0 0 0 320 0 1 1 320 0 1 1 320 0 1 1 576 0 0 0 320 0 1 1 320 0 1 1 320 0 1 1 320 0 1 1 320 0 1 1 320 0 1 1 320 0 1 1 576 0 0 0 320 0 1 1 576 0 0 0 576 0 0 0 320 0 1 1 320 0 1 1 320 0 1 1 320 0 1 1 320 0 1 1 320 0 1 1 320 0 1 1 576 0 0 0 576 0 0 0 576 0 0 0 576 0 0 0 576 0 0 0 320 0 1 1 576 0 0 0 576 0 0 0 576 0 0 0 576 0 0 0 320 0 1 1 576 0 0 0 576 0 0 0 576 0 0 0 576 0 0 0 576 0 0 0 320 0 1 1 320 0 1 1 320 0 1 1 576 0 0 0 320 0 1 1 576 0 0 0
576 0 0 0 320 0 1 1 576 0 0 0 576 0 0 0 320 0 1 1 576 0 0 0 576 0 0 0 576 0 0 0 320 0 1 1 576 0 0 0 320 0 1 1 576 0 0 0 576 0 0 0 576 0 0 0 576 0 0 0 576 0 0 0 320 0 1 1 576 0 0 0 320 0 1 1 576 0 0 0 576 0 0 0 320 0 1 1 576 0 0 0 576 0 0 0 576 0 0 0 576 0 0 0 576 0 0 0 576 0 0 0 576 0 0 0 576 0 0 0 576 0 0 0 576 0 0 0 576 0 0 0 320 0 1 1 576 0 0 0 576 0 0 0 576 0 0 0 576 0 0 0 320 0 1 1 576 0 0 0 320 0 1 1 320 0 1 1 320 0 1 1 576 0 0 0 576 0 0 0 576 0 0 0 576 0 0 0 576 0 0 0 320 0 1 1 576 0 0 0
576 0 0 0 320 0 1 1 576 0 0 0 576 0 0 0 320 0 1 1 576 0 0 0 576 0 0 0 576 0 0 0 320 0 1 1 576 0 0 0 320 0 1 1 576 0 0 0 576 0 0 0 576 0 0 0 576 0 0 0 576 0 0 0 320 0 1 1 576 0 0 0 320 0 1 1 576 0 0 0 576 0 0 0 320 0 1 1 576 0 0 0 576 0 0 0 320 0 1 1 576 0 0 0 576 0 0 0 576 0 0 0 576 0 0 0 576 0 0 0 576 0 0 0 576 0 0 0 576 0 0 0 576 0 0 0 576 0 0 0 576 0 0 0 576 0 0 0 576 0 0 0 320 0 1 1 576 0 0 0 320 0 1 1 576 0 0 0 320 0 1 1 576 0 0 0 576 0 0 0 576 0 0 0 576 0 0 0 576 0 0 0 320 0 1 1 576 0 0 0
576 0 0 0 320 0 1 1 576 0 0 0 576 0 0 0 320 0 1 1 576 0 0 0 576 0 0 0 576 0 0 0 320 0 1 1 576 0 0 0 320 0 1 1 576 0 0 0 320 0 1 1 320 0 1 1 576 0 0 0 576 0 0 0 320 0 1 1 576 0 0 0 320 0 1 1 576 0 0 0 576 0 0 0 320 0 1 1 576 0 0 0 576 0 0 0 320 0 1 1 576 0 0 0 576 0 0 0 576 0 0 0 576 0 0 0 576 0 0 0 576 0 0 0 576 0 0 0 576 0 0 0 576 0 0 0 576 0 0 0 576 0 0 0 576 0 0 0 576 0 0 0 320 0 1 1 576 0 0 0 320 0 1 1 576 0 0 0 320 0 1 1 576 0 0 0 576 0 0 0 576 0 0 0 576 0 0 0 576 0 0 0 320 0 1 1 576 0 0 0
576 0 0 0 320 0 1 1 576 0 0 0 576 0 0 0 320 0 1 1 576 0 0 0 576 0 0 0 576 0 0 0 320 0 1 1 576 0 0 0 320 0 1 1 576 0 0 0 576 0 0 0 320 0 1 1 576 0 0 0 576 0 0 0 320 0 1 1 320 0 1 1 320 0 1 1 576 0 0 0 576 0 0 0 320 0 1 1 576 0 0 0 576 0 0 0 320 0 1 1 576 0 0 0 320 0 1 1 320 0 1 1 320 0 1 1 320 0 1 1 320 0 1 1 576 0 0 0 576 0 0 0 320 0 1 1 320 0 1 1 320 0 1 1 320 0 1 1 320 0 1 1 320 0 1 1 576 0 0 0 320 0 1 1 576 0 0 0 320 0 1 1 320 0 1 1 320 0 1 1 320 0 1 1 320 0 1 1 576 0 0 0 320 0 1 1 576 0 0 0
576 0 0 0 320 0 1 1 320 0 1 1 576 0 0 0 320 0 1 1 576 0 0 0 576 0 0 0 576 0 0 0 320 0 1 1 576 0 0 0 320 0 1 1 320 0 1 1 320 0 1 1 320 0 1 1 576 0 0 0 576 0 0 0 576 0 0 0 576 0 0 0 576 0 0 0 576 0 0 0 576 0 0 0 320 0 1 1 576 0 0 0 576 0 0 0 320 0 1 1 576 0 0 0 576 0 0 0 576 0 0 0 576 0 0 0 576 0 0 0 320 0 1 1 576 0 0 0 576 0 0 0 320 0 1 1 576 0 0 0 576 0 0 0 576 0 0 0 576 0 0 0 320 0 1 1 576 0 0 0 320 0 1 1 576 0 0 0 576 0 0 0 576 0 0 0 576 0 0 0 576 0 0 0 576 0 0 0 576 0 0 0 320 0 1 1 576 0 0 0
576 0 0 0 320 0 1 1 576 0 0 0 576 0 0 0 320 0 1 1 576 0 0 0 576 0 0 0 576 0 0 0 320 0 1 1 576 0 0 0 320 0 1 1 576 0 0 0 576 0 0 0 576 0 0 0 576 0 0 0 576 0 0 0 576 0 0 0 576 0 0 0 576 0 0 0 576 0 0 0 576 0 0 0 320 0 1 1 576 0 0 0 576 0 0 0 320 0 1 1 576 0 0 0 576 0 0 0 576 0 0 0 576 0 0 0 576 0 0 0 320 0 1 1 576 0 0 0 576 0 0 0 320 0 1 1 576 0 0 0 576 0 0 0 576 0 0 0 576 0 0 0 320 0 1 1 576 0 0 0 320 0 1 1 320 0 1 1 320 0 1 1 320 0 1 1 320 0 1 1 320 0 1 1 320 0 1 1 576 0 0 0 320 0 1 1 576 0 0 0
576 0 0 0 320 0 1 1 576 0 0 0 576 0 0 0 320 0 1 1 576 0 0 0 576 0 0 0 576 0 0 0 320 0 1 1 576 0 0 0 320 0 1 1 576 0 0 0 576 0 0 0 320 0 1 1 320 0 1 1 320 0 1 1 320 0 1 1 320 0 1 1 320 0 1 1 320 0 1 1 320 0 1 1 320 0 1 1 576 0 0 0 576 0 0 0 320 0 1 1 320 0 1 1 320 0 1 1 320 0 1 1 320 0 1 1 576 0 0 0 320 0 1 1 576 0 0 0 576 0 0 0 320 0 1 1 576 0 0 0 576 0 0 0 576 0 0 0 576 0 0 0 320 0 1 1 576 0 0 0 576 0 0 0 576 0 0 0 576 0 0 0 576 0 0 0 576 0 0 0 576 0 0 0 320 0 1 1 576 0 0 0 320 0 1 1 576 0 0 0
576 0 0 0 320 0 1 1 576 0 0 0 576 0 0 0 320 0 1 1 576 0 0 0 576 0 0 0 576 0 0 0 320 0 1 1 576 0 0 0 320 0 1 1 576 0 0 0 576 0 0 0 576 0 0 0 576 0 0 0 576 0 0 0 576 0 0 0 576 0 0 0 576 0 0 0 576 0 0 0 576 0 0 0 576 0 0 0 576 0 0 0 576 0 0 0 320 0 1 1 576 0 0 0 576 0 0 0 576 0 0 0 320 0 1 1 576 0 0 0 320 0 1 1 576 0 0 0 576 0 0 0 320 0 1 1 576 0 0 0 320 0 1 1 576 0 0 0 576 0 0 0 320 0 1 1 576 0 0 0 576 0 0 0 576 0 0 0 576 0 0 0 576 0 0 0 576 0 0 0 576 0 0 0 320 0 1 1 576 0 0 0 320 0 1 1 576 0 0 0
576 0 0 0 320 0 1 1 576 0 0 0 576 0 0 0 320 0 1 1 576 0 0 0 576 0 0 0 576 0 0 0 320 0 1 1 576 0 0 0 320 0 1 1 576 0 0 0 576 0 0 0 576 0 0 0 576 0 0 0 576 0 0 0 576 0 0 0 576 0 0 0 576 0 0 0 576 0 0 0 576 0 0 0 576 0 0 0 576 0 0 0 576 0 0 0 320 0 1 1 576 0 0 0 576 0 0 0 576 0 0 0 320 0 1 1 576 0 0 0 320 0 1 1 576 0 0 0 576 0 0 0 320 0 1 1 576 0 0 0 320 0 1 1 576 0 0 0 576 0 0 0 320 0 1 1 320 0 1 1 320 0 1 1 320 0 1 1 320 0 1 1 320 0 1 1 320 0 1 1 576 0 0 0 320 0 1 1 576 0 0 0 320 0 1 1 576 0 0 0
576 0 0 0 320 0 1 1 576 0 0 0 576 0 0 0 320 0 1 1 576 0 0 0 320 0 1 1 576 0 0 0 320 0 1 1 320 0 1 1 320 0 1 1 320 0 1 1 320 0 1 1 320 0 1 1 320 0 1 1 320 0 1 1 320 0 1 1 320 0 1 1 320 0 1 1 320 0 1 1 320 0 1 1 320 0 1 1 320 0 1 1 320 0 1 1 320 0 1 1 576 0 0 0 576 0 0 0 576 0 0 0 320 0 1 1 576 0 0 0 320 0 1 1 576 0 0 0 576 0 0 0 320 0 1 1 320 0 1 1 320 0 1 1 576 0 0 0 576 0 0 0 320 0 1 1 576 0 0 0 576 0 0 0 576 0 0 0 576 0 0 0 576 0 0 0 320 0 1 1 576 0 0 0 320 0 1 1 320 0 1 1 320 0 1 1 576 0 0 0
576 0 0 0 320 0 1 1 576 0 0 0 576 0 0 0 320 0 1 1 576 0 0 0 320 0 1 1 576 0 0 0 576 0 0 0 576 0 0 0 576 0 0 0 576 0 0 0 576 0 0 0 576 0 0 0 576 0 0 0 576 0 0 0 576 0 0 0 576 0 0 0 576 0 0 0 576 0 0 0 576 0 0 0 576 0 0 0 576 0 0 0 576 0 0 0 576 0 0 0 576 0 0 0 576 0 0 0 576 0 0 0 320 0 1 1 576 0 0 0 320 0 1 1 576 0 0 0 576 0 0 0 576 0 0 0 320 0 1 1 576 0 0 0 576 0 0 0 576 0 0 0 320 0 1 1 576 0 0 0 320 0 1 1 320 0 1 1 320 0 1 1 576 0 0 0 320 0 1 1 576 0 0 0 576 0 0 0 576 0 0 0 320 0 1 1 576 0 0 0
576 0 0 0 320 0 1 1 576 0 0 0 576 0 0 0 320 0 1 1 576 0 0 0 320 0 1 1 576 0 0 0 576 0 0 0 576 0 0 0 576 0 0 0 576 0 0 0 576 0 0 0 576 0 0 0 576 0 0 0 576 0 0 0 576 0 0 0 576 0 0 0 576 0 0 0 576 0 0 0 576 0 0 0 576 0 0 0 576 0 0 0 576 0 0 0 576 0 0 0 576 0 0 0 576 0 0 0 576 0 0 0 320 0 1 1 576 0 0 0 320 0 1 1 576 0 0 0 576 0 0 0 576 0 0 0 320 0 1 1 576 0 0 0 576 0 0 0 576 0 0 0 320 0 1 1 576 0 0 0 576 0 0 0 576 0 0 0 320 0 1 1 576 0 0 0 320 0 1 1 576 0 0 0 576 0 0 0 576 0 0 0 320 0 1 1 576 0 0 0
576 0 0 0 320 0 1 1 576 0 0 0 320 0 1 1 320 0 1 1 320 0 1 1 320 0 1 1 320 0 1 1 320 0 1 1 320 0 1 1 320 0 1 1 320 0 1 1 576 0 0 0 576 0 0 0 576 0 0 0 576 0 0 0 576 0 0 0 320 0 1 1 320 0 1 1 320 0 1 1 320 0 1 1 320 0 1 1 320 0 1 1 320 0 1 1 320 0 1 1 320 0 1 1 320 0 1 1 576 0 0 0 320 0 1 1 576 0 0 0 320 0 1 1 320 0 1 1 320 0 1 1 320 0 1 1 320 0 1 1 576 0 0 0 576 0 0 0 576 0 0 0 320 0 1 1 320 0 1 1 320 0 1 1 320 0 1 1 320 0 1 1 576 0 0 0 320 0 1 1 576 0 0 0 576 0 0 0 576 0 0 0 320 0 1 1 576 0 0 0
576 0 0 0 320 0 1 1 576 0 0 0 576 0 0 0 576 0 0 0 576 0 0 0 576 0 0 0 576 0 0 0 576 0 0 0 576 0 0 0 576 0 0 0 576 0 0 0 576 0 0 0 576 0 0 0 576 0 0 0 576 0 0 0 576 0 0 0 320 0 1 1 576 0 0 0 576 0 0 0 576 0 0 0 576 0 0 0 576 0 0 0 576 0 0 0 576 0 0 0 576 0 0 0 320 0 1 1 576 0 0 0 320 0 1 1 576 0 0 0 320 0 1 1 576 0 0 0 576 0 0 0 576 0 0 0 320 0 1 1 320 0 1 1 320 0 1 1 576 0 0 0 576 0 0 0 576 0 0 0 576 0 0 0 576 0 0 0 576 0 0 0 576 0 0 0 320 0 1 1 320 0 1 1 320 0 1 1 576 0 0 0 320 0 1 1 576 0 0 0
576 0 0 0 320 0 1 1 320 0 1 1 320 0 1 1 320 0 1 1 320 0 1 1 320 0 1 1 320 0 1 1 320 0 1 1 320 0 1 1 320 0 1 1 320 0 1 1 320 0 1 1 320 0 1 1 320 0 1 1 320 0 1 1 320 0 1 1 320 0 1 1 576 0 0 0 576 0 0 0 576 0 0 0 320 0 1 1 320 0 1 1 320 0 1 1 320 0 1 1 576 0 0 0 320 0 1 1 576 0 0 0 320 0 1 1 576 0 0 0 320 0 1 1 576 0 0 0 576 0 0 0 576 0 0 0 320 0 1 1 576 0 0 0 320 0 1 1 576 0 0 0 576 0 0 0 576 0 0 0 576 0 0 0 320 0 1 1 320 0 1 1 320 0 1 1 320 0 1 1 576 0 0 0 320 0 1 1 576 0 0 0 320 0 1 1 576 0 0 0
576 0 0 0 320 0 1 1 576 0 0 0 576 0 0 0 576 0 0 0 576 0 0 0 576 0 0 0 576 0 0 0 576 0 0 0 576 0 0 0 576 0 0 0 576 0 0 0 576 0 0 0 576 0 0 0 320 0 1 1 576 0 0 0 576 0 0 0 576 0 0 0 576 0 0 0 576 0 0 0 576 0 0 0 320 0 1 1 576 0 0 0 576 0 0 0 576 0 0 0 576 0 0 0 320 0 1 1 576 0 0 0 320 0 1 1 576 0 0 0 320 0 1 1 576 0 0 0 576 0 0 0 576 0 0 0 576 0 0 0 576 0 0 0 320 0 1 1 576 0 0 0 576 0 0 0 576 0 0 0 576 0 0 0 320 0 1 1 576 0 0 0 576 0 0 0 576 0 0 0 576 0 0 0 320 0 1 1 576 0 0 0 320 0 1 1 576 0 0 0
576 0 0 0 320 0 1 1 576 0 0 0 320 0 1 1 320 0 1 1 320 0 1 1 320 0 1 1 320 0 1 1 576 0 0 0 576 0 0 0 320 0 1 1 576 0 0 0 576 0 0 0 576 0 0 0 320 0 1 1 576 0 0 0 576 0 0 0 576 0 0 0 320 0 1 1 320 0 1 1 320 0 1 1 320 0 1 1 320 0 1 1 576 0 0 0 576 0 0 0 576 0 0 0 320 0 1 1 576 0 0 0 320 0 1 1 576 0 0 0 320 0 1 1 576 0 0 0 576 0 0 0 576 0 0 0 576 0 0 0 576 0 0 0 320 0 1 1 576 0 0 0 576 0 0 0 576 0 0 0 576 0 0 0 320 0 1 1 576 0 0 0 576 0 0 0 576 0 0 0 576 0 0 0 320 0 1 1 576 0 0 0 320 0 1 1 576 0 0 0
576 0 0 0 320 0 1 1 576 0 0 0 320 0 1 1 576 0 0 0 576 0 0 0 576 0 0 0 320 0 1 1 576 0 0 0 576 0 0 0 320 0 1 1 576 0 0 0 576 0 0 0 576 0 0 0 320 0 1 1 576 0 0 0 320 0 1 1 320 0 1 1 320 0 1 1 576 0 0 0 576 0 0 0 576 0 0 0 320 0 1 1 576 0 0 0 576 0 0 0 320 0 1 1 320 0 1 1 576 0 0 0 320 0 1 1 576 0 0 0 320 0 1 1 576 0 0 0 576 0 0 0 576 0 0 0 576 0 0 0 576 0 0 0 320 0 1 1 576 0 0 0 576 0 0 0 576 0 0 0 576 0 0 0 320 0 1 1 576 0 0 0 320 0 1 1 320 0 1 1 320 0 1 1 320 0 1 1 576 0 0 0 320 0 1 1 576 0 0 0
576 0 0 0 320 0 1 1 576 0 0 0 320 0 1 1 576 0 0 0 320 0 1 1 576 0 0 0 320 0 1 1 576 0 0 0 576 0 0 0 320 0 1 1 576 0 0 0 576 0 0 0 576 0 0 0 320 0 1 1 576 0 0 0 576 0 0 0 576 0 0 0 576 0 0 0 576 0 0 0 576 0 0 0 576 0 0 0 320 0 1 1 576 0 0 0 576 0 0 0 320 0 1 1 576 0 0 0 576 0 0 0 320 0 1 1 576 0 0 0 320 0 1 1 576 0 0 0 576 0 0 0 576 0 0 0 576 0 0 0 576 0 0 0 320 0 1 1 576 0 0 0 576 0 0 0 576 0 0 0 576 0 0 0 320 0 1 1 576 0 0 0 576 0 0 0 576 0 0 0 576 0 0 0 320 0 1 1 576 0 0 0 320 0 1 1 576 0 0 0
576 0 0 0 320 0 1 1 576 0 0 0 320 0 1 1 576 0 0 0 320 0 1 1 576 0 0 0 320 0 1 1 576 0 0 0 576 0 0 0 320 0 1 1 576 0 0 0 576 0 0 0 576 0 0 0 320 0 1 1 320 0 1 1 320 0 1 1 320 0 1 1 320 0 1 1 320 0 1 1 320 0 1 1 320 0 1 1 320 0 1 1 576 0 0 0 320 0 1 1 320 0 1 1 576 0 0 0 576 0 0 0 320 0 1 1 576 0 0 0 320 0 1 1 320 0 1 1 320 0 1 1 320 0 1 1 320 0 1 1 320 0 1 1 320 0 1 1 320 0 1 1 320 0 1 1 320 0 1 1 320 0 1 1 320 0 1 1 320 0 1 1 320 0 1 1 576 0 0 0 576 0 0 0 320 0 1 1 576 0 0 0 320 0 1 1 576 0 0 0
576 0 0 0 320 0 1 1 576 0 0 0 320 0 1 1 576 0 0 0 320 0 1 1 576 0 0 0 320 0 1 1 576 0 0 0 576 0 0 0 320 0 1 1 576 0 0 0 576 0 0 0 576 0 0 0 576 0 0 0 576 0 0 0 576 0 0 0 576 0 0 0 576 0 0 0 576 0 0 0 576 0 0 0 576 0 0 0 576 0 0 0 576 0 0 0 320 0 1 1 576 0 0 0 576 0 0 0 576 0 0 0 320 0 1 1 576 0 0 0 576 0 0 0 576 0 0 0 576 0 0 0 576 0 0 0 576 0 0 0 576 0 0 0 576 0 0 0 576 0 0 0 576 0 0 0 576 0 0 0 576 0 0 0 576 0 0 0 576 0 0 0 320 0 1 1 576 0 0 0 576 0 0 0 320 0 1 1 576 0 0 0 320 0 1 1 576 0 0 0
576 0 0 0 320 0 1 1 576 0 0 0 320 0 1 1 320 0 1 1 320 0 1 1 576 0 0 0 320 0 1 1 576 0 0 0 576 0 0 0 320 0 1 1 576 0 0 0 576 0 0 0 576 0 0 0 576 0 0 0 576 0 0 0 576 0 0 0 576 0 0 0 576 0 0 0 576 0 0 0 576 0 0 0 576 0 0 0 576 0 0 0 576 0 0 0 320 0 1 1 576 0 0 0 320 0 1 1 320 0 1 1 320 0 1 1 320 0 1 1 320 0 1 1 320 0 1 1 320 0 1 1 320 0 1 1 320 0 1 1 320 0 1 1 320 0 1 1 320 0 1 1 320 0 1 1 320 0 1 1 320 0 1 1 320 0 1 1 576 0 0 0 320 0 1 1 576 0 0 0 576 0 0 0 320 0 1 1 576 0 0 0 320 0 1 1 576 0 0 0
576 0 0 0 320 0 1 1 576 0 0 0 576 0 0 0 576 0 0 0 576 0 0 0 576 0 0 0 320 0 1 1 576 0 0 0 576 0 0 0 320 0 1 1 320 0 1 1 320 0 1 1 320 0 1 1 320 0 1 1 320 0 1 1 320 0 1 1 320 0 1 1 320 0 1 1 320 0 1 1 320 0 1 1 320 0 1 1 576 0 0 0 576 0 0 0 320 0 1 1 576 0 0 0 320 0 1 1 576 0 0 0 576 0 0 0 576 0 0 0 576 0 0 0 576 0 0 0 576 0 0 0 576 0 0 0 576 0 0 0 576 0 0 0 576 0 0 0 576 0 0 0 576 0 0 0 576 0 0 0 576 0 0 0 320 0 1 1 576 0 0 0 320 0 1 1 576 0 0 0 576 0 0 0 576 0 0 0 576 0 0 0 320 0 1 1 576 0 0 0
576 0 0 0 320 0 1 1 576 0 0 0 576 0 0 0 576 0 0 0 576 0 0 0 320 0 1 1 320 0 1 1 576 0 0 0 576 0 0 0 320 0 1 1 576 0 0 0 576 0 0 0 576 0 0 0 576 0 0 0 576 0 0 0 576 0 0 0 576 0 0 0 576 0 0 0 576 0 0 0 576 0 0 0 320 0 1 1 576 0 0 0 576 0 0 0 320 0 1 1 576 0 0 0 320 0 1 1 576 0 0 0 320 0 1 1 320 0 1 1 320 0 1 1 320 0 1 1 320 0 1 1 320 0 1 1 320 0 1 1 320 0 1 1 320 0 1 1 320 0 1 1 320 0 1 1 320 0 1 1 576 0 0 0 320 0 1 1 576 0 0 0 320 0 1 1 576 0 0 0 576 0 0 0 576 0 0 0 576 0 0 0 320 0 1 1 576 0 0 0
576 0 0 0 320 0 1 1 320 0 1 1 320 0 1 1 576 0 0 0 576 0 0 0 320 0 1 1 576 0 0 0 576 0 0 0 576 0 0 0 320 0 1 1 576 0 0 0 320 0 1 1 576 0 0 0 320 0 1 1 320 0 1 1 320 0 1 1 320 0 1 1 320 0 1 1 320 0 1 1 320 0 1 1 320 0 1 1 576 0 0 0 576 0 0 0 320 0 1 1 576 0 0 0 320 0 1 1 576 0 0 0 320 0 1 1 576 0 0 0 576 0 0 0 576 0 0 0 576 0 0 0 576 0 0 0 576 0 0 0 576 0 0 0 576 0 0 0 576 0 0 0 576 0 0 0 320 0 1 1 576 0 0 0 320 0 1 1 576 0 0 0 320 0 1 1 576 0 0 0 576 0 0 0 576 0 0 0 576 0 0 0 320 0 1 1 576 0 0 0
576 0 0 0 320 0 1 1 576 0 0 0 320 0 1 1 576 0 0 0 576 0 0 0 320 0 1 1 576 0 0 0 576 0 0 0 576 0 0 0 320 0 1 1 576 0 0 0 320 0 1 1 576 0 0 0 320 0 1 1 576 0 0 0 576 0 0 0 576 0 0 0 576 0 0 0 576 0 0 0 576 0 0 0 576 0 0 0 576 0 0 0 576 0 0 0 320 0 1 1 576 0 0 0 320 0 1 1 576 0 0 0 320 0 1 1 576 0 0 0 320 0 1 1 320 0 1 1 320 0 1 1 320 0 1 1 320 0 1 1 320 0 1 1 320 0 1 1 320 0 1 1 576 0 0 0 320 0 1 1 576 0 0 0 320 0 1 1 576 0 0 0 320 0 1 1 320 0 1 1 320 0 1 1 320 0 1 1 576 0 0 0 320 0 1 1 576 0 0 0
576 0 0 0 320 0 1 1 576 0 0 0 320 0 1 1 576 0 0 0 576 0 0 0 320 0 1 1 576 0 0 0 320 0 1 1 320 0 1 1 320 0 1 1 576 0 0 0 320 0 1 1 320 0 1 1 320 0 1 1 320 0 1 1 320 0 1 1 320 0 1 1 320 0 1 1 320 0 1 1 576 0 0 0 576 0 0 0 320 0 1 1 320 0 1 1 320 0 1 1 576 0 0 0 320 0 1 1 576 0 0 0 320 0 1 1 576 0 0 0 320 0 1 1 576 0 0 0 576 0 0 0 576 0 0 0 576 0 0 0 576 0 0 0 576 0 0 0 320 0 1 1 576 0 0 0 320 0 1 1 576 0 0 0 320 0 1 1 576 0 0 0 320 0 1 1 576 0 0 0 576 0 0 0 576 0 0 0 576 0 0 0 320 0 1 1 576 0 0 0
576 0 0 0 320 0 1 1 576 0 0 0 320 0 1 1 576 0 0 0 576 0 0 0 320 0 1 1 576 0 0 0 320 0 1 1 576 0 0 0 576 0 0 0 576 0 0 0 576 0 0 0 576 0 0 0 576 0 0 0 576 0 0 0 576 0 0 0 576 0 0 0 576 0 0 0 576 0 0 0 576 0 0 0 576 0 0 0 320 0 1 1 576 0 0 0 576 0 0 0 576 0 0 0 320 0 1 1 576 0 0 0 320 0 1 1 576 0 0 0 320 0 1 1 576 0 0 0 320 0 1 1 320 0 1 1 320 0 1 1 320 0 1 1 320 0 1 1 320 0 1 1 576 0 0 0 320 0 1 1 576 0 0 0 320 0 1 1 576 0 0 0 320 0 1 1 576 0 0 0 576 0 0 0 576 0 0 0 576 0 0 0 320 0 1 1 576 0 0 0
576 0 0 0 320 0 1 1 576 0 0 0 320 0 1 1 576 0 0 0 576 0 0 0 320 0 1 1 576 0 0 0 320 0 1 1 576 0 0 0 576 0 0 0 576 0 0 0 576 0 0 0 576 0 0 0 576 0 0 0 576 0 0 0 576 0 0 0 576 0 0 0 576 0 0 0 576 0 0 0 576 0 0 0 576 0 0 0 320 0 1 1 576 0 0 0 576 0 0 0 576 0 0 0 320 0 1 1 576 0 0 0 320 0 1 1 576 0 0 0 320 0 1 1 576 0 0 0 320 0 1 1 576 0 0 0 576 0 0 0 576 0 0 0 576 0 0 0 576 0 0 0 576 0 0 0 320 0 1 1 576 0 0 0 320 0 1 1 576 0 0 0 320 0 1 1 576 0 0 0 576 0 0 0 576 0 0 0 576 0 0 0 320 0 1 1 576 0 0 0
576 0 0 0 320 0 1 1 576 0 0 0 576 0 0 0 576 0 0 0 576 0 0 0 320 0 1 1 576 0 0 0 320 0 1 1 320 0 1 1 320 0 1 1 320 0 1 1 320 0 1 1 320 0 1 1 320 0 1 1 320 0 1 1 320 0 1 1 320 0 1 1 320 0 1 1 320 0 1 1 320 0 1 1 320 0 1 1 320 0 1 1 576 0 0 0 576 0 0 0 576 0 0 0 576 0 0 0 576 0 0 0 320 0 1 1 576 0 0 0 320 0 1 1 576 0 0 0 576 0 0 0 576 0 0 0 576 0 0 0 576 0 0 0 576 0 0 0 576 0 0 0 576 0 0 0 320 0 1 1 576 0 0 0 320 0 1 1 576 0 0 0 320 0 1 1 576 0 0 0 576 0 0 0 576 0 0 0 576 0 0 0 320 0 1 1 576 0 0 0
576 0 0 0 320 0 1 1 576 0 0 0 576 0 0 0 576 0 0 0 576 0 0 0 320 0 1 1 576 0 0 0 576 0 0 0 576 0 0 0 576 0 0 0 576 0 0 0 576 0 0 0 576 0 0 0 576 0 0 0 576 0 0 0 576 0 0 0 576 0 0 0 576 0 0 0 576 0 0 0 576 0 0 0 576 0 0 0 576 0 0 0 576 0 0 0 576 0 0 0 576 0 0 0 576 0 0 0 576 0 0 0 320 0 1 1 576 0 0 0 320 0 1 1 320 0 1 1 320 0 1 1 320 0 1 1 320 0 1 1 320 0 1 1 320 0 1 1 320 0 1 1 320 0 1 1 320 0 1 1 576 0 0 0 320 0 1 1 576 0 0 0 576 0 0 0 576 0 0 0 576 0 0 0 576 0 0 0 576 0 0 0 576 0 0 0 576 0 0 0
576 0 0 0 320 0 1 1 576 0 0 0 576 0 0 0 576 0 0 0 576 0 0 0 320 0 1 1 576 0 0 0 576 0 0 0 576 0 0 0 576 0 0 0 576 0 0 0 576 0 0 0 576 0 0 0 576 0 0 0 576 0 0 0 576 0 0 0 576 0 0 0 576 0 0 0 576 0 0 0 576 0 0 0 576 0 0 0 576 0 0 0 576 0 0 0 576 0 0 0 576 0 0 0 576 0 0 0 576 0 0 0 320 0 1 1 576 0 0 0 576 0 0 0 576 0 0 0 576 0 0 0 576 0 0 0 576 0 0 0 576 0 0 0 576 0 0 0 576 0 0 0 576 0 0 0 576 0 0 0 576 0 0 0 320 0 1 1 576 0 0 0 576 0 0 0 576 0 0 0 576 0 0 0 576 0 0 0 576 0 0 0 256 0 2 0 576 0 0 0
576 0 0 0 320 0 1 1 320 0 1 1 320 0 1 1 320 0 1 1 320 0 1 1 320 0 1 1 320 0 1 1 320 0 1 1 320 0 1 1 320 0 1 1 320 0 1 1 320 0 1 1 320 0 1 1 320 0 1 1 320 0 1 1 320 0 1 1 320 0 1 1 320 0 1 1 320 0 1 1 320 0 1 1 320 0 1 1 320 0 1 1 320 0 1 1 320 0 1 1 320 0 1 1 320 0 1 1 320 0 1 1 320 0 1 1 320 0 1 1 320 0 1 1 320 0 1 1 320 0 1 1 320 0 1 1 320 0 1 1 320 0 1 1 320 0 1 1 320 0 1 1 320 0 1 1 320 0 1 1 320 0 1 1 320 0 1 1 320 0 1 1 320 0 1 1 320 0 1 1 320 0 1 1 320 0 1 1 320 0 1 1 320 0 1 1 576 0 0 0
576 0 0 0 576 0 0 0 576 0 0 0 576 0 0 0 576 0 0 0 576 0 0 0 576 0 0 0 576 0 0 0 576 0 0 0 576 0 0 0 576 0 0 0 576 0 0 0 576 0 0 0 576 0 0 0 576 0 0 0 576 0 0 0 576 0 0 0 576 0 0 0 576 0 0 0 576 0 0 0 576 0 0 0 576 0 0 0 576 0 0 0 576 0 0 0 576 0 0 0 576 0 0 0 576 0 0 0 576 0 0 0 576 0 0 0 576 0 0 0 576 0 0 0 576 0 0 0 576 0 0 0 576 0 0 0 576 0 0 0 576 0 0 0 576 0 0 0 576 0 0 0 576 0 0 0 576 0 0 0 576 0 0 0 576 0 0 0 576 0 0 0 576 0 0 0 576 0 0 0 576 0 0 0 576 0 0 0 576 0 0 0 576 0 0 0 576 0 0 0